id,ward,precinct,total,Yes,Yes Percent,No,No Percent
0101,1,1,552,283,51.27,269,48.73
0102,1,2,500,235,47.0,265,53.0
0103,1,3,629,349,55.48,280,44.52
0104,1,4,617,373,60.45,244,39.55
0105,1,5,549,307,55.92,242,44.08
0106,1,6,480,280,58.33,200,41.67
0107,1,7,385,217,56.36,168,43.64
0108,1,8,462,247,53.46,215,46.54
0109,1,9,388,213,54.9,175,45.1
0110,1,10,658,369,56.08,289,43.92
0111,1,11,612,336,54.9,276,45.1
0112,1,12,656,300,45.73,356,54.27
0113,1,13,278,142,51.08,136,48.92
0114,1,14,500,282,56.4,218,43.6
0115,1,15,495,257,51.92,238,48.08
0116,1,16,595,290,48.74,305,51.26
0117,1,17,474,216,45.57,258,54.43
0118,1,18,527,255,48.39,272,51.61
0119,1,19,653,315,48.24,338,51.76
0120,1,20,440,208,47.27,232,52.73
0121,1,21,739,419,56.7,320,43.3
0122,1,22,368,191,51.9,177,48.1
0123,1,23,719,331,46.04,388,53.96
0124,1,24,494,233,47.17,261,52.83
0125,1,25,526,269,51.14,257,48.86
0126,1,26,367,185,50.41,182,49.59
0127,1,27,608,349,57.4,259,42.6
0128,1,28,182,117,64.29,65,35.71
0129,1,29,685,374,54.6,311,45.4
0130,1,30,616,280,45.45,336,54.55
0131,1,31,483,284,58.8,199,41.2
0132,1,32,530,291,54.91,239,45.09
0133,1,33,599,357,59.6,242,40.4
0134,1,34,445,220,49.44,225,50.56
0135,1,35,679,378,55.67,301,44.33
0136,1,36,635,373,58.74,262,41.26
0137,1,37,531,309,58.19,222,41.81
0138,1,38,511,278,54.4,233,45.6
0139,1,39,449,266,59.24,183,40.76
0140,1,40,471,279,59.24,192,40.76
0141,1,41,315,163,51.75,152,48.25
0142,1,42,185,99,53.51,86,46.49
0143,1,43,352,197,55.97,155,44.03
0144,1,44,517,243,47.0,274,53.0
0201,2,1,617,346,56.08,271,43.92
0202,2,2,376,268,71.28,108,28.72
0203,2,3,627,341,54.39,286,45.61
0204,2,4,542,299,55.17,243,44.83
0205,2,5,658,365,55.47,293,44.53
0206,2,6,579,311,53.71,268,46.29
0207,2,7,477,291,61.01,186,38.99
0208,2,8,676,358,52.96,318,47.04
0209,2,9,491,335,68.23,156,31.77
0210,2,10,391,305,78.01,86,21.99
0211,2,11,529,387,73.16,142,26.84
0212,2,12,425,281,66.12,144,33.88
0213,2,13,434,317,73.04,117,26.96
0214,2,14,546,295,54.03,251,45.97
0215,2,15,479,261,54.49,218,45.51
0216,2,16,527,305,57.87,222,42.13
0217,2,17,628,301,47.93,327,52.07
0218,2,18,471,347,73.67,124,26.33
0219,2,19,349,251,71.92,98,28.08
0220,2,20,648,423,65.28,225,34.72
0221,2,21,574,293,51.05,281,48.95
0222,2,22,522,373,71.46,149,28.54
0223,2,23,344,281,81.69,63,18.31
0224,2,24,447,325,72.71,122,27.29
0225,2,25,593,323,54.47,270,45.53
0226,2,26,411,252,61.31,159,38.69
0227,2,27,453,305,67.33,148,32.67
0228,2,28,591,408,69.04,183,30.96
0229,2,29,557,370,66.43,187,33.57
0230,2,30,452,332,73.45,120,26.55
0231,2,31,554,412,74.37,142,25.63
0232,2,32,455,302,66.37,153,33.63
0233,2,33,716,508,70.95,208,29.05
0234,2,34,378,289,76.46,89,23.54
0235,2,35,656,448,68.29,208,31.71
0236,2,36,528,350,66.29,178,33.71
0237,2,37,434,296,68.2,138,31.8
0238,2,38,449,322,71.71,127,28.29
0239,2,39,355,240,67.61,115,32.39
0240,2,40,701,478,68.19,223,31.81
0241,2,41,598,410,68.56,188,31.44
0242,2,42,564,399,70.74,165,29.26
0243,2,43,695,498,71.65,197,28.35
0244,2,44,308,214,69.48,94,30.52
0245,2,45,575,397,69.04,178,30.96
0246,2,46,274,169,61.68,105,38.32
0301,3,1,692,363,52.46,329,47.54
0302,3,2,508,288,56.69,220,43.31
0303,3,3,397,229,57.68,168,42.32
0304,3,4,557,274,49.19,283,50.81
0305,3,5,287,166,57.84,121,42.16
0306,3,6,703,409,58.18,294,41.82
0307,3,7,279,152,54.48,127,45.52
0308,3,8,380,191,50.26,189,49.74
0309,3,9,577,253,43.85,324,56.15
0310,3,10,227,127,55.95,100,44.05
0311,3,11,562,287,51.07,275,48.93
0312,3,12,455,240,52.75,215,47.25
0313,3,13,593,360,60.71,233,39.29
0314,3,14,568,338,59.51,230,40.49
0315,3,15,477,231,48.43,246,51.57
0316,3,16,412,207,50.24,205,49.76
0317,3,17,734,387,52.72,347,47.28
0318,3,18,662,369,55.74,293,44.26
0319,3,19,618,407,65.86,211,34.14
0320,3,20,538,275,51.12,263,48.88
0321,3,21,532,373,70.11,159,29.89
0322,3,22,715,437,61.12,278,38.88
0323,3,23,418,250,59.81,168,40.19
0324,3,24,445,247,55.51,198,44.49
0325,3,25,870,601,69.08,269,30.92
0326,3,26,572,351,61.36,221,38.64
0327,3,27,662,407,61.48,255,38.52
0328,3,28,238,128,53.78,110,46.22
0329,3,29,505,292,57.82,213,42.18
0330,3,30,429,205,47.79,224,52.21
0331,3,31,589,277,47.03,312,52.97
0332,3,32,811,495,61.04,316,38.96
0333,3,33,640,407,63.59,233,36.41
0334,3,34,758,432,56.99,326,43.01
0335,3,35,275,133,48.36,142,51.64
0336,3,36,233,135,57.94,98,42.06
0337,3,37,476,236,49.58,240,50.42
0338,3,38,351,196,55.84,155,44.16
0339,3,39,1016,634,62.4,382,37.6
0340,3,40,517,316,61.12,201,38.88
0341,3,41,337,189,56.08,148,43.92
0401,4,1,763,331,43.38,432,56.62
0402,4,2,706,417,59.07,289,40.93
0403,4,3,420,210,50.0,210,50.0
0404,4,4,685,336,49.05,349,50.95
0405,4,5,551,241,43.74,310,56.26
0406,4,6,550,309,56.18,241,43.82
0407,4,7,666,309,46.4,357,53.6
0408,4,8,582,243,41.75,339,58.25
0409,4,9,552,283,51.27,269,48.73
0410,4,10,649,297,45.76,352,54.24
0411,4,11,517,265,51.26,252,48.74
0412,4,12,685,316,46.13,369,53.87
0413,4,13,679,392,57.73,287,42.27
0414,4,14,527,265,50.28,262,49.72
0415,4,15,582,280,48.11,302,51.89
0416,4,16,918,547,59.59,371,40.41
0417,4,17,622,358,57.56,264,42.44
0418,4,18,497,267,53.72,230,46.28
0419,4,19,365,189,51.78,176,48.22
0420,4,20,402,251,62.44,151,37.56
0421,4,21,597,338,56.62,259,43.38
0422,4,22,485,244,50.31,241,49.69
0423,4,23,653,315,48.24,338,51.76
0424,4,24,493,232,47.06,261,52.94
0425,4,25,643,399,62.05,244,37.95
0426,4,26,454,247,54.41,207,45.59
0427,4,27,710,319,44.93,391,55.07
0428,4,28,467,229,49.04,238,50.96
0429,4,29,488,227,46.52,261,53.48
0430,4,30,708,372,52.54,336,47.46
0431,4,31,437,241,55.15,196,44.85
0432,4,32,585,272,46.5,313,53.5
0433,4,33,501,234,46.71,267,53.29
0434,4,34,466,224,48.07,242,51.93
0435,4,35,615,312,50.73,303,49.27
0436,4,36,634,308,48.58,326,51.42
0437,4,37,990,603,60.91,387,39.09
0438,4,38,581,301,51.81,280,48.19
0501,5,1,443,235,53.05,208,46.95
0502,5,2,366,213,58.2,153,41.8
0503,5,3,498,246,49.4,252,50.6
0504,5,4,639,297,46.48,342,53.52
0505,5,5,427,248,58.08,179,41.92
0506,5,6,361,207,57.34,154,42.66
0507,5,7,466,248,53.22,218,46.78
0508,5,8,476,266,55.88,210,44.12
0509,5,9,562,275,48.93,287,51.07
0510,5,10,394,201,51.02,193,48.98
0511,5,11,471,234,49.68,237,50.32
0512,5,12,307,177,57.65,130,42.35
0513,5,13,423,220,52.01,203,47.99
0514,5,14,383,200,52.22,183,47.78
0515,5,15,455,245,53.85,210,46.15
0516,5,16,463,227,49.03,236,50.97
0517,5,17,386,218,56.48,168,43.52
0518,5,18,470,232,49.36,238,50.64
0519,5,19,449,227,50.56,222,49.44
0520,5,20,512,265,51.76,247,48.24
0521,5,21,491,252,51.32,239,48.68
0522,5,22,576,313,54.34,263,45.66
0523,5,23,823,433,52.61,390,47.39
0524,5,24,620,279,45.0,341,55.0
0525,5,25,416,223,53.61,193,46.39
0526,5,26,463,250,54.0,213,46.0
0527,5,27,477,255,53.46,222,46.54
0528,5,28,476,261,54.83,215,45.17
0529,5,29,487,266,54.62,221,45.38
0530,5,30,300,151,50.33,149,49.67
0531,5,31,361,204,56.51,157,43.49
0532,5,32,523,293,56.02,230,43.98
0533,5,33,446,249,55.83,197,44.17
0534,5,34,487,270,55.44,217,44.56
0535,5,35,623,342,54.9,281,45.1
0536,5,36,272,174,63.97,98,36.03
0537,5,37,502,294,58.57,208,41.43
0538,5,38,439,244,55.58,195,44.42
0539,5,39,393,220,55.98,173,44.02
0540,5,40,372,194,52.15,178,47.85
0541,5,41,215,117,54.42,98,45.58
0601,6,1,407,212,52.09,195,47.91
0602,6,2,386,194,50.26,192,49.74
0603,6,3,390,233,59.74,157,40.26
0604,6,4,281,154,54.8,127,45.2
0605,6,5,244,130,53.28,114,46.72
0606,6,6,465,237,50.97,228,49.03
0607,6,7,385,209,54.29,176,45.71
0608,6,8,403,226,56.08,177,43.92
0609,6,9,406,237,58.37,169,41.63
0610,6,10,258,148,57.36,110,42.64
0611,6,11,339,188,55.46,151,44.54
0612,6,12,295,162,54.92,133,45.08
0613,6,13,286,145,50.7,141,49.3
0614,6,14,350,193,55.14,157,44.86
0615,6,15,329,189,57.45,140,42.55
0616,6,16,414,199,48.07,215,51.93
0617,6,17,259,155,59.85,104,40.15
0618,6,18,274,187,68.25,87,31.75
0619,6,19,311,173,55.63,138,44.37
0620,6,20,247,140,56.68,107,43.32
0621,6,21,181,101,55.8,80,44.2
0622,6,22,231,134,58.01,97,41.99
0623,6,23,183,99,54.1,84,45.9
0624,6,24,199,124,62.31,75,37.69
0625,6,25,201,117,58.21,84,41.79
0626,6,26,278,160,57.55,118,42.45
0627,6,27,230,142,61.74,88,38.26
0628,6,28,190,102,53.68,88,46.32
0629,6,29,389,189,48.59,200,51.41
0630,6,30,322,188,58.39,134,41.61
0631,6,31,345,198,57.39,147,42.61
0632,6,32,398,196,49.25,202,50.75
0633,6,33,387,230,59.43,157,40.57
0634,6,34,385,226,58.7,159,41.3
0635,6,35,357,177,49.58,180,50.42
0636,6,36,411,223,54.26,188,45.74
0637,6,37,421,229,54.39,192,45.61
0638,6,38,423,208,49.17,215,50.83
0639,6,39,327,178,54.43,149,45.57
0640,6,40,340,189,55.59,151,44.41
0641,6,41,384,194,50.52,190,49.48
0642,6,42,368,210,57.07,158,42.93
0643,6,43,349,184,52.72,165,47.28
0644,6,44,408,217,53.19,191,46.81
0645,6,45,381,177,46.46,204,53.54
0646,6,46,296,166,56.08,130,43.92
0647,6,47,264,167,63.26,97,36.74
0648,6,48,361,204,56.51,157,43.49
0701,7,1,375,201,53.6,174,46.4
0702,7,2,348,198,56.9,150,43.1
0703,7,3,366,189,51.64,177,48.36
0704,7,4,372,206,55.38,166,44.62
0705,7,5,314,184,58.6,130,41.4
0706,7,6,466,221,47.42,245,52.58
0707,7,7,359,201,55.99,158,44.01
0708,7,8,211,116,54.98,95,45.02
0709,7,9,609,342,56.16,267,43.84
0710,7,10,375,190,50.67,185,49.33
0711,7,11,399,206,51.63,193,48.37
0712,7,12,327,188,57.49,139,42.51
0713,7,13,206,121,58.74,85,41.26
0714,7,14,417,236,56.59,181,43.41
0715,7,15,346,176,50.87,170,49.13
0716,7,16,351,189,53.85,162,46.15
0717,7,17,296,168,56.76,128,43.24
0718,7,18,327,191,58.41,136,41.59
0719,7,19,344,204,59.3,140,40.7
0720,7,20,304,193,63.49,111,36.51
0721,7,21,294,173,58.84,121,41.16
0722,7,22,311,181,58.2,130,41.8
0723,7,23,339,180,53.1,159,46.9
0724,7,24,293,171,58.36,122,41.64
0725,7,25,308,177,57.47,131,42.53
0726,7,26,286,151,52.8,135,47.2
0727,7,27,270,159,58.89,111,41.11
0728,7,28,272,152,55.88,120,44.12
0729,7,29,336,169,50.3,167,49.7
0730,7,30,296,197,66.55,99,33.45
0731,7,31,263,153,58.17,110,41.83
0732,7,32,455,222,48.79,233,51.21
0733,7,33,437,229,52.4,208,47.6
0734,7,34,453,244,53.86,209,46.14
0735,7,35,403,224,55.58,179,44.42
0736,7,36,464,242,52.16,222,47.84
0737,7,37,363,211,58.13,152,41.87
0738,7,38,335,203,60.6,132,39.4
0739,7,39,337,194,57.57,143,42.43
0740,7,40,299,169,56.52,130,43.48
0741,7,41,346,202,58.38,144,41.62
0742,7,42,355,217,61.13,138,38.87
0743,7,43,343,207,60.35,136,39.65
0744,7,44,327,207,63.3,120,36.7
0745,7,45,341,200,58.65,141,41.35
0746,7,46,94,62,65.96,32,34.04
0801,8,1,341,194,56.89,147,43.11
0802,8,2,362,190,52.49,172,47.51
0803,8,3,414,177,42.75,237,57.25
0804,8,4,433,216,49.88,217,50.12
0805,8,5,329,165,50.15,164,49.85
0806,8,6,358,198,55.31,160,44.69
0807,8,7,429,229,53.38,200,46.62
0808,8,8,381,199,52.23,182,47.77
0809,8,9,246,126,51.22,120,48.78
0810,8,10,472,226,47.88,246,52.12
0811,8,11,310,161,51.94,149,48.06
0812,8,12,334,189,56.59,145,43.41
0813,8,13,441,250,56.69,191,43.31
0814,8,14,301,162,53.82,139,46.18
0815,8,15,239,139,58.16,100,41.84
0816,8,16,114,69,60.53,45,39.47
0817,8,17,314,159,50.64,155,49.36
0818,8,18,334,198,59.28,136,40.72
0819,8,19,413,219,53.03,194,46.97
0820,8,20,432,214,49.54,218,50.46
0821,8,21,482,259,53.73,223,46.27
0822,8,22,348,189,54.31,159,45.69
0823,8,23,296,171,57.77,125,42.23
0824,8,24,201,95,47.26,106,52.74
0825,8,25,373,195,52.28,178,47.72
0826,8,26,322,179,55.59,143,44.41
0827,8,27,413,195,47.22,218,52.78
0828,8,28,394,196,49.75,198,50.25
0829,8,29,401,200,49.88,201,50.12
0830,8,30,413,216,52.3,197,47.7
0831,8,31,293,160,54.61,133,45.39
0832,8,32,306,174,56.86,132,43.14
0833,8,33,285,142,49.82,143,50.18
0834,8,34,340,183,53.82,157,46.18
0835,8,35,424,200,47.17,224,52.83
0836,8,36,385,193,50.13,192,49.87
0837,8,37,300,148,49.33,152,50.67
0838,8,38,274,155,56.57,119,43.43
0839,8,39,361,193,53.46,168,46.54
0840,8,40,304,157,51.64,147,48.36
0841,8,41,395,216,54.68,179,45.32
0842,8,42,497,258,51.91,239,48.09
0843,8,43,215,107,49.77,108,50.23
0844,8,44,261,159,60.92,102,39.08
0845,8,45,331,190,57.4,141,42.6
0846,8,46,306,169,55.23,137,44.77
0847,8,47,312,146,46.79,166,53.21
0848,8,48,334,179,53.59,155,46.41
0849,8,49,353,174,49.29,179,50.71
0850,8,50,369,199,53.93,170,46.07
0851,8,51,360,179,49.72,181,50.28
0852,8,52,465,216,46.45,249,53.55
0853,8,53,219,134,61.19,85,38.81
0854,8,54,322,178,55.28,144,44.72
0855,8,55,273,165,60.44,108,39.56
0856,8,56,394,191,48.48,203,51.52
0901,9,1,345,189,54.78,156,45.22
0902,9,2,293,168,57.34,125,42.66
0903,9,3,227,150,66.08,77,33.92
0904,9,4,277,162,58.48,115,41.52
0905,9,5,373,207,55.5,166,44.5
0906,9,6,338,185,54.73,153,45.27
0907,9,7,287,185,64.46,102,35.54
0908,9,8,379,224,59.1,155,40.9
0909,9,9,405,211,52.1,194,47.9
0910,9,10,267,152,56.93,115,43.07
0911,9,11,260,148,56.92,112,43.08
0912,9,12,395,221,55.95,174,44.05
0913,9,13,392,209,53.32,183,46.68
0914,9,14,411,226,54.99,185,45.01
0915,9,15,361,199,55.12,162,44.88
0916,9,16,355,189,53.24,166,46.76
0917,9,17,237,157,66.24,80,33.76
0918,9,18,258,140,54.26,118,45.74
0919,9,19,370,214,57.84,156,42.16
0920,9,20,332,205,61.75,127,38.25
0921,9,21,333,190,57.06,143,42.94
0922,9,22,404,223,55.2,181,44.8
0923,9,23,386,188,48.7,198,51.3
0924,9,24,364,192,52.75,172,47.25
0925,9,25,314,178,56.69,136,43.31
0926,9,26,315,194,61.59,121,38.41
0927,9,27,297,186,62.63,111,37.37
0928,9,28,234,154,65.81,80,34.19
0929,9,29,321,189,58.88,132,41.12
0930,9,30,297,170,57.24,127,42.76
0931,9,31,299,171,57.19,128,42.81
0932,9,32,362,182,50.28,180,49.72
0933,9,33,261,162,62.07,99,37.93
0934,9,34,301,200,66.45,101,33.55
0935,9,35,324,164,50.62,160,49.38
0936,9,36,300,168,56.0,132,44.0
0937,9,37,543,284,52.3,259,47.7
0938,9,38,333,187,56.16,146,43.84
0939,9,39,378,204,53.97,174,46.03
0940,9,40,400,228,57.0,172,43.0
0941,9,41,290,163,56.21,127,43.79
0942,9,42,365,194,53.15,171,46.85
0943,9,43,318,184,57.86,134,42.14
0944,9,44,336,189,56.25,147,43.75
0945,9,45,270,149,55.19,121,44.81
0946,9,46,351,204,58.12,147,41.88
0947,9,47,371,212,57.14,159,42.86
0948,9,48,347,186,53.6,161,46.4
0949,9,49,383,226,59.01,157,40.99
0950,9,50,486,240,49.38,246,50.62
0951,9,51,354,200,56.5,154,43.5
1001,10,1,294,197,67.01,97,32.99
1002,10,2,377,250,66.31,127,33.69
1003,10,3,392,229,58.42,163,41.58
1004,10,4,288,162,56.25,126,43.75
1005,10,5,299,201,67.22,98,32.78
1006,10,6,301,189,62.79,112,37.21
1007,10,7,291,193,66.32,98,33.68
1008,10,8,190,115,60.53,75,39.47
1009,10,9,359,236,65.74,123,34.26
1010,10,10,419,250,59.67,169,40.33
1011,10,11,505,324,64.16,181,35.84
1012,10,12,280,162,57.86,118,42.14
1013,10,13,335,225,67.16,110,32.84
1014,10,14,485,321,66.19,164,33.81
1015,10,15,644,387,60.09,257,39.91
1016,10,16,319,217,68.03,102,31.97
1017,10,17,504,312,61.9,192,38.1
1018,10,18,221,134,60.63,87,39.37
1019,10,19,410,262,63.9,148,36.1
1020,10,20,400,267,66.75,133,33.25
1021,10,21,379,255,67.28,124,32.72
1022,10,22,232,158,68.1,74,31.9
1023,10,23,325,218,67.08,107,32.92
1024,10,24,361,240,66.48,121,33.52
1025,10,25,109,75,68.81,34,31.19
1026,10,26,270,187,69.26,83,30.74
1027,10,27,326,195,59.82,131,40.18
1028,10,28,438,295,67.35,143,32.65
1029,10,29,406,286,70.44,120,29.56
1030,10,30,348,217,62.36,131,37.64
1031,10,31,338,210,62.13,128,37.87
1032,10,32,415,263,63.37,152,36.63
1033,10,33,306,171,55.88,135,44.12
1034,10,34,257,150,58.37,107,41.63
1035,10,35,416,260,62.5,156,37.5
1036,10,36,94,59,62.77,35,37.23
1101,11,1,416,256,61.54,160,38.46
1102,11,2,34,15,44.12,19,55.88
1103,11,3,465,194,41.72,271,58.28
1104,11,4,328,208,63.41,120,36.59
1105,11,5,610,301,49.34,309,50.66
1106,11,6,711,434,61.04,277,38.96
1107,11,7,437,261,59.73,176,40.27
1108,11,8,433,266,61.43,167,38.57
1109,11,9,402,244,60.7,158,39.3
1110,11,10,444,298,67.12,146,32.88
1111,11,11,502,318,63.35,184,36.65
1112,11,12,595,440,73.95,155,26.05
1113,11,13,566,375,66.25,191,33.75
1114,11,14,224,138,61.61,86,38.39
1115,11,15,173,112,64.74,61,35.26
1116,11,16,319,219,68.65,100,31.35
1117,11,17,569,308,54.13,261,45.87
1118,11,18,358,232,64.8,126,35.2
1119,11,19,608,301,49.51,307,50.49
1120,11,20,319,211,66.14,108,33.86
1121,11,21,543,357,65.75,186,34.25
1122,11,22,591,326,55.16,265,44.84
1123,11,23,244,156,63.93,88,36.07
1124,11,24,526,373,70.91,153,29.09
1125,11,25,555,333,60.0,222,40.0
1126,11,26,479,293,61.17,186,38.83
1127,11,27,183,114,62.3,69,37.7
1128,11,28,213,149,69.95,64,30.05
1129,11,29,551,373,67.7,178,32.3
1130,11,30,242,149,61.57,93,38.43
1131,11,31,433,297,68.59,136,31.41
1132,11,32,208,133,63.94,75,36.06
1133,11,33,581,373,64.2,208,35.8
1134,11,34,142,79,55.63,63,44.37
1135,11,35,74,47,63.51,27,36.49
1136,11,36,210,137,65.24,73,34.76
1137,11,37,127,77,60.63,50,39.37
1138,11,38,236,116,49.15,120,50.85
1201,12,1,403,213,52.85,190,47.15
1202,12,2,330,217,65.76,113,34.24
1203,12,3,498,254,51.0,244,49.0
1204,12,4,482,256,53.11,226,46.89
1205,12,5,342,205,59.94,137,40.06
1206,12,6,463,270,58.32,193,41.68
1207,12,7,386,225,58.29,161,41.71
1208,12,8,405,253,62.47,152,37.53
1209,12,9,335,206,61.49,129,38.51
1210,12,10,531,257,48.4,274,51.6
1211,12,11,430,263,61.16,167,38.84
1212,12,12,412,275,66.75,137,33.25
1213,12,13,441,270,61.22,171,38.78
1214,12,14,350,215,61.43,135,38.57
1215,12,15,360,209,58.06,151,41.94
1216,12,16,349,208,59.6,141,40.4
1217,12,17,486,293,60.29,193,39.71
1218,12,18,380,213,56.05,167,43.95
1219,12,19,395,242,61.27,153,38.73
1220,12,20,500,310,62.0,190,38.0
1221,12,21,433,250,57.74,183,42.26
1222,12,22,395,231,58.48,164,41.52
1223,12,23,417,240,57.55,177,42.45
1301,13,1,341,222,65.1,119,34.9
1302,13,2,276,188,68.12,88,31.88
1303,13,3,305,193,63.28,112,36.72
1304,13,4,411,255,62.04,156,37.96
1305,13,5,439,315,71.75,124,28.25
1306,13,6,333,220,66.07,113,33.93
1307,13,7,310,200,64.52,110,35.48
1308,13,8,286,198,69.23,88,30.77
1309,13,9,412,275,66.75,137,33.25
1310,13,10,323,212,65.63,111,34.37
1311,13,11,387,256,66.15,131,33.85
1312,13,12,342,206,60.23,136,39.77
1313,13,13,359,235,65.46,124,34.54
1314,13,14,352,246,69.89,106,30.11
1315,13,15,508,322,63.39,186,36.61
1316,13,16,272,188,69.12,84,30.88
1317,13,17,339,223,65.78,116,34.22
1318,13,18,312,197,63.14,115,36.86
1319,13,19,473,322,68.08,151,31.92
1320,13,20,257,167,64.98,90,35.02
1321,13,21,407,274,67.32,133,32.68
1322,13,22,396,275,69.44,121,30.56
1323,13,23,312,196,62.82,116,37.18
1324,13,24,371,236,63.61,135,36.39
1325,13,25,373,241,64.61,132,35.39
1326,13,26,370,256,69.19,114,30.81
1327,13,27,339,220,64.9,119,35.1
1328,13,28,281,183,65.12,98,34.88
1329,13,29,328,211,64.33,117,35.67
1330,13,30,300,208,69.33,92,30.67
1331,13,31,415,288,69.4,127,30.6
1332,13,32,314,205,65.29,109,34.71
1333,13,33,358,244,68.16,114,31.84
1334,13,34,368,252,68.48,116,31.52
1335,13,35,321,229,71.34,92,28.66
1336,13,36,264,166,62.88,98,37.12
1337,13,37,356,250,70.22,106,29.78
1338,13,38,307,198,64.5,109,35.5
1339,13,39,364,252,69.23,112,30.77
1340,13,40,338,241,71.3,97,28.7
1341,13,41,445,288,64.72,157,35.28
1342,13,42,378,253,66.93,125,33.07
1343,13,43,348,221,63.51,127,36.49
1344,13,44,380,247,65.0,133,35.0
1345,13,45,403,284,70.47,119,29.53
1346,13,46,426,295,69.25,131,30.75
1347,13,47,395,271,68.61,124,31.39
1348,13,48,296,202,68.24,94,31.76
1401,14,1,420,284,67.62,136,32.38
1402,14,2,554,377,68.05,177,31.95
1403,14,3,382,243,63.61,139,36.39
1404,14,4,393,256,65.14,137,34.86
1405,14,5,561,341,60.78,220,39.22
1406,14,6,217,144,66.36,73,33.64
1407,14,7,540,351,65.0,189,35.0
1408,14,8,498,330,66.27,168,33.73
1409,14,9,490,297,60.61,193,39.39
1410,14,10,296,187,63.18,109,36.82
1411,14,11,243,155,63.79,88,36.21
1412,14,12,423,269,63.59,154,36.41
1413,14,13,370,228,61.62,142,38.38
1414,14,14,384,256,66.67,128,33.33
1415,14,15,400,253,63.25,147,36.75
1416,14,16,287,185,64.46,102,35.54
1417,14,17,356,211,59.27,145,40.73
1418,14,18,190,123,64.74,67,35.26
1419,14,19,386,262,67.88,124,32.12
1420,14,20,322,224,69.57,98,30.43
1421,14,21,391,246,62.92,145,37.08
1422,14,22,530,360,67.92,170,32.08
1423,14,23,283,179,63.25,104,36.75
1424,14,24,457,333,72.87,124,27.13
1425,14,25,209,137,65.55,72,34.45
1426,14,26,299,198,66.22,101,33.78
1427,14,27,388,242,62.37,146,37.63
1428,14,28,363,223,61.43,140,38.57
1429,14,29,297,185,62.29,112,37.71
1430,14,30,283,186,65.72,97,34.28
1431,14,31,222,137,61.71,85,38.29
1501,15,1,338,199,58.88,139,41.12
1502,15,2,216,128,59.26,88,40.74
1503,15,3,236,148,62.71,88,37.29
1504,15,4,394,258,65.48,136,34.52
1505,15,5,360,225,62.5,135,37.5
1506,15,6,402,256,63.68,146,36.32
1507,15,7,192,106,55.21,86,44.79
1508,15,8,383,237,61.88,146,38.12
1509,15,9,510,333,65.29,177,34.71
1510,15,10,534,332,62.17,202,37.83
1511,15,11,473,289,61.1,184,38.9
1512,15,12,475,322,67.79,153,32.21
1513,15,13,386,231,59.84,155,40.16
1514,15,14,351,212,60.4,139,39.6
1515,15,15,336,204,60.71,132,39.29
1516,15,16,438,303,69.18,135,30.82
1517,15,17,207,127,61.35,80,38.65
1518,15,18,142,87,61.27,55,38.73
1519,15,19,325,207,63.69,118,36.31
1520,15,20,224,141,62.95,83,37.05
1521,15,21,173,90,52.02,83,47.98
1522,15,22,203,114,56.16,89,43.84
1523,15,23,237,159,67.09,78,32.91
1524,15,24,204,104,50.98,100,49.02
1601,16,1,481,313,65.07,168,34.93
1602,16,2,272,149,54.78,123,45.22
1603,16,3,266,189,71.05,77,28.95
1604,16,4,311,166,53.38,145,46.62
1605,16,5,219,134,61.19,85,38.81
1606,16,6,241,140,58.09,101,41.91
1607,16,7,290,157,54.14,133,45.86
1608,16,8,204,128,62.75,76,37.25
1609,16,9,283,152,53.71,131,46.29
1610,16,10,238,137,57.56,101,42.44
1611,16,11,306,182,59.48,124,40.52
1612,16,12,274,154,56.2,120,43.8
1613,16,13,342,211,61.7,131,38.3
1614,16,14,225,138,61.33,87,38.67
1615,16,15,287,163,56.79,124,43.21
1616,16,16,223,122,54.71,101,45.29
1617,16,17,402,263,65.42,139,34.58
1618,16,18,333,226,67.87,107,32.13
1619,16,19,275,153,55.64,122,44.36
1620,16,20,195,119,61.03,76,38.97
1621,16,21,242,160,66.12,82,33.88
1622,16,22,238,153,64.29,85,35.71
1623,16,23,401,255,63.59,146,36.41
1624,16,24,142,98,69.01,44,30.99
1625,16,25,331,196,59.21,135,40.79
1626,16,26,196,109,55.61,87,44.39
1627,16,27,198,117,59.09,81,40.91
1628,16,28,220,125,56.82,95,43.18
1629,16,29,220,145,65.91,75,34.09
1630,16,30,198,131,66.16,67,33.84
1631,16,31,253,149,58.89,104,41.11
1632,16,32,400,255,63.75,145,36.25
1633,16,33,205,132,64.39,73,35.61
1634,16,34,233,152,65.24,81,34.76
1635,16,35,441,283,64.17,158,35.83
1636,16,36,191,123,64.4,68,35.6
1701,17,1,384,227,59.11,157,40.89
1702,17,2,312,184,58.97,128,41.03
1703,17,3,340,189,55.59,151,44.41
1704,17,4,371,181,48.79,190,51.21
1705,17,5,261,140,53.64,121,46.36
1706,17,6,361,219,60.66,142,39.34
1707,17,7,360,233,64.72,127,35.28
1708,17,8,229,130,56.77,99,43.23
1709,17,9,266,151,56.77,115,43.23
1710,17,10,430,264,61.4,166,38.6
1711,17,11,257,166,64.59,91,35.41
1712,17,12,506,325,64.23,181,35.77
1713,17,13,241,147,61.0,94,39.0
1714,17,14,379,252,66.49,127,33.51
1715,17,15,344,189,54.94,155,45.06
1716,17,16,409,261,63.81,148,36.19
1717,17,17,348,195,56.03,153,43.97
1718,17,18,391,218,55.75,173,44.25
1719,17,19,206,119,57.77,87,42.23
1720,17,20,420,239,56.9,181,43.1
1721,17,21,385,198,51.43,187,48.57
1722,17,22,325,178,54.77,147,45.23
1723,17,23,226,125,55.31,101,44.69
1724,17,24,266,159,59.77,107,40.23
1725,17,25,270,158,58.52,112,41.48
1726,17,26,329,208,63.22,121,36.78
1727,17,27,202,113,55.94,89,44.06
1728,17,28,240,148,61.67,92,38.33
1729,17,29,310,179,57.74,131,42.26
1730,17,30,347,221,63.69,126,36.31
1731,17,31,217,130,59.91,87,40.09
1732,17,32,257,166,64.59,91,35.41
1733,17,33,200,119,59.5,81,40.5
1734,17,34,256,171,66.8,85,33.2
1735,17,35,228,132,57.89,96,42.11
1736,17,36,239,138,57.74,101,42.26
1737,17,37,270,161,59.63,109,40.37
1738,17,38,356,198,55.62,158,44.38
1739,17,39,318,175,55.03,143,44.97
1740,17,40,381,225,59.06,156,40.94
1741,17,41,441,269,61.0,172,39.0
1801,18,1,384,228,59.38,156,40.63
1802,18,2,462,276,59.74,186,40.26
1803,18,3,346,237,68.5,109,31.5
1804,18,4,413,219,53.03,194,46.97
1805,18,5,251,150,59.76,101,40.24
1806,18,6,350,230,65.71,120,34.29
1807,18,7,396,235,59.34,161,40.66
1808,18,8,400,214,53.5,186,46.5
1809,18,9,364,209,57.42,155,42.58
1810,18,10,492,255,51.83,237,48.17
1811,18,11,375,218,58.13,157,41.87
1812,18,12,375,223,59.47,152,40.53
1813,18,13,433,256,59.12,177,40.88
1814,18,14,396,224,56.57,172,43.43
1815,18,15,424,256,60.38,168,39.62
1816,18,16,384,197,51.3,187,48.7
1817,18,17,411,242,58.88,169,41.12
1818,18,18,300,170,56.67,130,43.33
1819,18,19,339,199,58.7,140,41.3
1820,18,20,279,161,57.71,118,42.29
1821,18,21,501,259,51.7,242,48.3
1822,18,22,424,240,56.6,184,43.4
1823,18,23,391,202,51.66,189,48.34
1824,18,24,373,242,64.88,131,35.12
1825,18,25,420,252,60.0,168,40.0
1826,18,26,474,263,55.49,211,44.51
1827,18,27,348,204,58.62,144,41.38
1828,18,28,372,248,66.67,124,33.33
1829,18,29,465,266,57.2,199,42.8
1830,18,30,482,283,58.71,199,41.29
1831,18,31,418,234,55.98,184,44.02
1832,18,32,371,180,48.52,191,51.48
1833,18,33,293,172,58.7,121,41.3
1834,18,34,422,234,55.45,188,44.55
1835,18,35,453,223,49.23,230,50.77
1836,18,36,429,283,65.97,146,34.03
1837,18,37,450,244,54.22,206,45.78
1838,18,38,342,207,60.53,135,39.47
1839,18,39,335,192,57.31,143,42.69
1840,18,40,433,280,64.67,153,35.33
1841,18,41,468,258,55.13,210,44.87
1842,18,42,343,193,56.27,150,43.73
1843,18,43,342,220,64.33,122,35.67
1844,18,44,354,231,65.25,123,34.75
1845,18,45,408,277,67.89,131,32.11
1846,18,46,463,284,61.34,179,38.66
1847,18,47,306,171,55.88,135,44.12
1848,18,48,293,170,58.02,123,41.98
1849,18,49,260,134,51.54,126,48.46
1850,18,50,279,155,55.56,124,44.44
1901,19,1,397,305,76.83,92,23.17
1902,19,2,572,336,58.74,236,41.26
1903,19,3,360,263,73.06,97,26.94
1904,19,4,505,351,69.5,154,30.5
1905,19,5,471,301,63.91,170,36.09
1906,19,6,463,318,68.68,145,31.32
1907,19,7,380,266,70.0,114,30.0
1908,19,8,485,357,73.61,128,26.39
1909,19,9,310,239,77.1,71,22.9
1910,19,10,536,345,64.37,191,35.63
1911,19,11,418,284,67.94,134,32.06
1912,19,12,380,283,74.47,97,25.53
1913,19,13,500,260,52.0,240,48.0
1914,19,14,456,315,69.08,141,30.92
1915,19,15,575,377,65.57,198,34.43
1916,19,16,430,302,70.23,128,29.77
1917,19,17,387,269,69.51,118,30.49
1918,19,18,438,335,76.48,103,23.52
1919,19,19,547,367,67.09,180,32.91
1920,19,20,351,227,64.67,124,35.33
1921,19,21,461,299,64.86,162,35.14
1922,19,22,473,324,68.5,149,31.5
1923,19,23,439,345,78.59,94,21.41
1924,19,24,341,233,68.33,108,31.67
1925,19,25,428,304,71.03,124,28.97
1926,19,26,427,298,69.79,129,30.21
1927,19,27,422,215,50.95,207,49.05
1928,19,28,495,264,53.33,231,46.67
1929,19,29,443,289,65.24,154,34.76
1930,19,30,428,291,67.99,137,32.01
1931,19,31,398,295,74.12,103,25.88
1932,19,32,399,253,63.41,146,36.59
1933,19,33,469,344,73.35,125,26.65
1934,19,34,394,288,73.1,106,26.9
1935,19,35,399,276,69.17,123,30.83
1936,19,36,584,323,55.31,261,44.69
1937,19,37,433,236,54.5,197,45.5
1938,19,38,391,220,56.27,171,43.73
1939,19,39,208,118,56.73,90,43.27
1940,19,40,464,312,67.24,152,32.76
1941,19,41,431,305,70.77,126,29.23
1942,19,42,353,222,62.89,131,37.11
1943,19,43,572,304,53.15,268,46.85
1944,19,44,474,310,65.4,164,34.6
1945,19,45,464,324,69.83,140,30.17
1946,19,46,431,332,77.03,99,22.97
1947,19,47,618,351,56.8,267,43.2
1948,19,48,496,275,55.44,221,44.56
1949,19,49,522,288,55.17,234,44.83
1950,19,50,381,263,69.03,118,30.97
1951,19,51,481,369,76.72,112,23.28
1952,19,52,537,352,65.55,185,34.45
1953,19,53,397,288,72.54,109,27.46
1954,19,54,355,230,64.79,125,35.21
1955,19,55,380,283,74.47,97,25.53
1956,19,56,465,317,68.17,148,31.83
1957,19,57,365,245,67.12,120,32.88
2001,20,1,425,252,59.29,173,40.71
2002,20,2,128,73,57.03,55,42.97
2003,20,3,367,214,58.31,153,41.69
2004,20,4,166,102,61.45,64,38.55
2005,20,5,432,235,54.4,197,45.6
2006,20,6,164,94,57.32,70,42.68
2007,20,7,469,266,56.72,203,43.28
2008,20,8,336,214,63.69,122,36.31
2009,20,9,528,264,50.0,264,50.0
2010,20,10,263,148,56.27,115,43.73
2011,20,11,502,244,48.61,258,51.39
2012,20,12,379,220,58.05,159,41.95
2013,20,13,334,209,62.57,125,37.43
2014,20,14,203,113,55.67,90,44.33
2015,20,15,398,256,64.32,142,35.68
2016,20,16,464,273,58.84,191,41.16
2017,20,17,252,144,57.14,108,42.86
2018,20,18,260,136,52.31,124,47.69
2019,20,19,416,220,52.88,196,47.12
2020,20,20,285,171,60.0,114,40.0
2021,20,21,311,190,61.09,121,38.91
2022,20,22,520,257,49.42,263,50.58
2023,20,23,231,133,57.58,98,42.42
2024,20,24,470,241,51.28,229,48.72
2025,20,25,250,145,58.0,105,42.0
2026,20,26,360,193,53.61,167,46.39
2027,20,27,184,102,55.43,82,44.57
2028,20,28,231,139,60.17,92,39.83
2029,20,29,262,137,52.29,125,47.71
2030,20,30,169,113,66.86,56,33.14
2031,20,31,452,274,60.62,178,39.38
2032,20,32,293,180,61.43,113,38.57
2033,20,33,247,128,51.82,119,48.18
2034,20,34,468,246,52.56,222,47.44
2035,20,35,287,153,53.31,134,46.69
2036,20,36,125,83,66.4,42,33.6
2037,20,37,116,61,52.59,55,47.41
2038,20,38,109,60,55.05,49,44.95
2039,20,39,29,14,48.28,15,51.72
2101,21,1,420,217,51.67,203,48.33
2102,21,2,246,122,49.59,124,50.41
2103,21,3,377,198,52.52,179,47.48
2104,21,4,328,188,57.32,140,42.68
2105,21,5,388,219,56.44,169,43.56
2106,21,6,308,174,56.49,134,43.51
2107,21,7,365,208,56.99,157,43.01
2108,21,8,380,242,63.68,138,36.32
2109,21,9,393,223,56.74,170,43.26
2110,21,10,306,177,57.84,129,42.16
2111,21,11,324,155,47.84,169,52.16
2112,21,12,315,166,52.7,149,47.3
2113,21,13,398,215,54.02,183,45.98
2114,21,14,406,233,57.39,173,42.61
2115,21,15,334,201,60.18,133,39.82
2116,21,16,327,171,52.29,156,47.71
2117,21,17,306,181,59.15,125,40.85
2118,21,18,331,189,57.1,142,42.9
2119,21,19,425,268,63.06,157,36.94
2120,21,20,323,190,58.82,133,41.18
2121,21,21,335,194,57.91,141,42.09
2122,21,22,335,175,52.24,160,47.76
2123,21,23,341,209,61.29,132,38.71
2124,21,24,393,238,60.56,155,39.44
2125,21,25,321,179,55.76,142,44.24
2126,21,26,369,191,51.76,178,48.24
2127,21,27,417,225,53.96,192,46.04
2128,21,28,448,252,56.25,196,43.75
2129,21,29,406,231,56.9,175,43.1
2130,21,30,304,163,53.62,141,46.38
2131,21,31,214,123,57.48,91,42.52
2132,21,32,268,143,53.36,125,46.64
2133,21,33,313,174,55.59,139,44.41
2134,21,34,347,215,61.96,132,38.04
2135,21,35,438,251,57.31,187,42.69
2136,21,36,359,217,60.45,142,39.55
2137,21,37,259,143,55.21,116,44.79
2138,21,38,370,226,61.08,144,38.92
2139,21,39,362,218,60.22,144,39.78
2140,21,40,334,195,58.38,139,41.62
2141,21,41,397,227,57.18,170,42.82
2142,21,42,408,235,57.6,173,42.4
2143,21,43,361,184,50.97,177,49.03
2144,21,44,393,220,55.98,173,44.02
2145,21,45,366,205,56.01,161,43.99
2146,21,46,387,237,61.24,150,38.76
2147,21,47,332,188,56.63,144,43.37
2148,21,48,381,226,59.32,155,40.68
2149,21,49,403,213,52.85,190,47.15
2150,21,50,276,161,58.33,115,41.67
2151,21,51,379,208,54.88,171,45.12
2152,21,52,360,206,57.22,154,42.78
2153,21,53,317,165,52.05,152,47.95
2154,21,54,282,156,55.32,126,44.68
2201,22,1,209,119,56.94,90,43.06
2202,22,2,479,320,66.81,159,33.19
2203,22,3,594,337,56.73,257,43.27
2204,22,4,314,192,61.15,122,38.85
2205,22,5,357,216,60.5,141,39.5
2206,22,6,367,208,56.68,159,43.32
2207,22,7,326,217,66.56,109,33.44
2208,22,8,542,371,68.45,171,31.55
2209,22,9,307,187,60.91,120,39.09
2210,22,10,508,272,53.54,236,46.46
2211,22,11,275,146,53.09,129,46.91
2212,22,12,297,171,57.58,126,42.42
2213,22,13,400,235,58.75,165,41.25
2214,22,14,304,188,61.84,116,38.16
2215,22,15,327,183,55.96,144,44.04
2216,22,16,318,202,63.52,116,36.48
2217,22,17,511,294,57.53,217,42.47
2218,22,18,337,212,62.91,125,37.09
2219,22,19,189,101,53.44,88,46.56
2220,22,20,400,240,60.0,160,40.0
2221,22,21,369,193,52.3,176,47.7
2222,22,22,377,201,53.32,176,46.68
2223,22,23,393,233,59.29,160,40.71
2224,22,24,449,271,60.36,178,39.64
2225,22,25,376,240,63.83,136,36.17
2301,23,1,364,228,62.64,136,37.36
2302,23,2,404,270,66.83,134,33.17
2303,23,3,352,241,68.47,111,31.53
2304,23,4,365,237,64.93,128,35.07
2305,23,5,385,273,70.91,112,29.09
2306,23,6,375,245,65.33,130,34.67
2307,23,7,361,235,65.1,126,34.9
2308,23,8,455,282,61.98,173,38.02
2309,23,9,371,251,67.65,120,32.35
2310,23,10,451,307,68.07,144,31.93
2311,23,11,435,292,67.13,143,32.87
2312,23,12,410,272,66.34,138,33.66
2313,23,13,364,252,69.23,112,30.77
2314,23,14,330,215,65.15,115,34.85
2315,23,15,339,222,65.49,117,34.51
2316,23,16,380,264,69.47,116,30.53
2317,23,17,310,187,60.32,123,39.68
2318,23,18,353,233,66.01,120,33.99
2319,23,19,336,212,63.1,124,36.9
2320,23,20,268,176,65.67,92,34.33
2321,23,21,348,229,65.8,119,34.2
2322,23,22,369,244,66.12,125,33.88
2323,23,23,373,235,63.0,138,37.0
2324,23,24,348,222,63.79,126,36.21
2325,23,25,343,223,65.01,120,34.99
2326,23,26,389,273,70.18,116,29.82
2327,23,27,341,234,68.62,107,31.38
2328,23,28,433,292,67.44,141,32.56
2329,23,29,331,220,66.47,111,33.53
2330,23,30,462,275,59.52,187,40.48
2331,23,31,327,184,56.27,143,43.73
2332,23,32,379,242,63.85,137,36.15
2333,23,33,419,293,69.93,126,30.07
2334,23,34,416,275,66.11,141,33.89
2335,23,35,293,193,65.87,100,34.13
2336,23,36,375,253,67.47,122,32.53
2337,23,37,410,276,67.32,134,32.68
2338,23,38,359,244,67.97,115,32.03
2339,23,39,412,254,61.65,158,38.35
2401,24,1,260,138,53.08,122,46.92
2402,24,2,313,178,56.87,135,43.13
2403,24,3,376,211,56.12,165,43.88
2404,24,4,256,138,53.91,118,46.09
2405,24,5,179,107,59.78,72,40.22
2406,24,6,334,193,57.78,141,42.22
2407,24,7,234,141,60.26,93,39.74
2408,24,8,154,71,46.1,83,53.9
2409,24,9,289,174,60.21,115,39.79
2410,24,10,155,86,55.48,69,44.52
2411,24,11,320,196,61.25,124,38.75
2412,24,12,199,112,56.28,87,43.72
2413,24,13,203,99,48.77,104,51.23
2414,24,14,256,146,57.03,110,42.97
2415,24,15,162,104,64.2,58,35.8
2416,24,16,947,492,51.95,455,48.05
2417,24,17,230,124,53.91,106,46.09
2418,24,18,276,141,51.09,135,48.91
2419,24,19,346,174,50.29,172,49.71
2420,24,20,270,151,55.93,119,44.07
2421,24,21,172,85,49.42,87,50.58
2422,24,22,380,198,52.11,182,47.89
2423,24,23,267,156,58.43,111,41.57
2424,24,24,365,204,55.89,161,44.11
2425,24,25,236,122,51.69,114,48.31
2426,24,26,464,264,56.9,200,43.1
2427,24,27,336,165,49.11,171,50.89
2428,24,28,195,112,57.44,83,42.56
2429,24,29,226,122,53.98,104,46.02
2430,24,30,195,96,49.23,99,50.77
2431,24,31,335,170,50.75,165,49.25
2432,24,32,160,96,60.0,64,40.0
2433,24,33,198,110,55.56,88,44.44
2434,24,34,303,160,52.81,143,47.19
2435,24,35,279,143,51.25,136,48.75
2436,24,36,362,211,58.29,151,41.71
2437,24,37,150,84,56.0,66,44.0
2438,24,38,254,121,47.64,133,52.36
2439,24,39,290,163,56.21,127,43.79
2440,24,40,367,215,58.58,152,41.42
2441,24,41,147,89,60.54,58,39.46
2501,25,1,380,200,52.63,180,47.37
2502,25,2,603,282,46.77,321,53.23
2503,25,3,772,491,63.6,281,36.4
2504,25,4,368,211,57.34,157,42.66
2505,25,5,474,249,52.53,225,47.47
2506,25,6,153,93,60.78,60,39.22
2507,25,7,496,253,51.01,243,48.99
2508,25,8,557,269,48.29,288,51.71
2509,25,9,468,243,51.92,225,48.08
2510,25,10,629,438,69.63,191,30.37
2511,25,11,527,284,53.89,243,46.11
2512,25,12,475,246,51.79,229,48.21
2513,25,13,557,309,55.48,248,44.52
2514,25,14,314,199,63.38,115,36.62
2515,25,15,414,214,51.69,200,48.31
2516,25,16,747,517,69.21,230,30.79
2517,25,17,499,268,53.71,231,46.29
2518,25,18,248,158,63.71,90,36.29
2519,25,19,499,236,47.29,263,52.71
2520,25,20,265,134,50.57,131,49.43
2521,25,21,893,562,62.93,331,37.07
2522,25,22,500,247,49.4,253,50.6
2523,25,23,538,292,54.28,246,45.72
2524,25,24,495,254,51.31,241,48.69
2525,25,25,422,277,65.64,145,34.36
2526,25,26,482,263,54.56,219,45.44
2527,25,27,599,384,64.11,215,35.89
2528,25,28,507,235,46.35,272,53.65
2529,25,29,352,226,64.2,126,35.8
2530,25,30,482,218,45.23,264,54.77
2531,25,31,882,623,70.63,259,29.37
2532,25,32,394,212,53.81,182,46.19
2601,26,1,394,184,46.7,210,53.3
2602,26,2,298,128,42.95,170,57.05
2603,26,3,452,257,56.86,195,43.14
2604,26,4,269,150,55.76,119,44.24
2605,26,5,337,154,45.7,183,54.3
2606,26,6,318,176,55.35,142,44.65
2607,26,7,370,169,45.68,201,54.32
2608,26,8,237,134,56.54,103,43.46
2609,26,9,315,192,60.95,123,39.05
2610,26,10,383,188,49.09,195,50.91
2611,26,11,367,155,42.23,212,57.77
2612,26,12,379,199,52.51,180,47.49
2613,26,13,203,122,60.1,81,39.9
2614,26,14,308,143,46.43,165,53.57
2615,26,15,230,151,65.65,79,34.35
2616,26,16,203,112,55.17,91,44.83
2617,26,17,342,209,61.11,133,38.89
2618,26,18,279,154,55.2,125,44.8
2619,26,19,226,129,57.08,97,42.92
2620,26,20,319,146,45.77,173,54.23
2621,26,21,452,221,48.89,231,51.11
2622,26,22,199,119,59.8,80,40.2
2623,26,23,271,158,58.3,113,41.7
2624,26,24,290,143,49.31,147,50.69
2625,26,25,271,125,46.13,146,53.87
2626,26,26,269,121,44.98,148,55.02
2627,26,27,419,197,47.02,222,52.98
2628,26,28,474,269,56.75,205,43.25
2629,26,29,193,98,50.78,95,49.22
2630,26,30,294,134,45.58,160,54.42
2631,26,31,171,89,52.05,82,47.95
2632,26,32,440,259,58.86,181,41.14
2633,26,33,420,200,47.62,220,52.38
2634,26,34,383,176,45.95,207,54.05
2635,26,35,311,152,48.87,159,51.13
2636,26,36,356,149,41.85,207,58.15
2637,26,37,390,214,54.87,176,45.13
2638,26,38,176,106,60.23,70,39.77
2639,26,39,417,206,49.4,211,50.6
2640,26,40,226,106,46.9,120,53.1
2641,26,41,420,198,47.14,222,52.86
2642,26,42,303,148,48.84,155,51.16
2643,26,43,232,144,62.07,88,37.93
2644,26,44,185,130,70.27,55,29.73
2645,26,45,184,114,61.96,70,38.04
2646,26,46,270,138,51.11,132,48.89
2647,26,47,251,153,60.96,98,39.04
2648,26,48,386,183,47.41,203,52.59
2649,26,49,226,143,63.27,83,36.73
2701,27,1,949,585,61.64,364,38.36
2702,27,2,448,283,63.17,165,36.83
2703,27,3,192,106,55.21,86,44.79
2704,27,4,221,109,49.32,112,50.68
2705,27,5,313,174,55.59,139,44.41
2706,27,6,483,296,61.28,187,38.72
2707,27,7,605,346,57.19,259,42.81
2708,27,8,332,209,62.95,123,37.05
2709,27,9,199,128,64.32,71,35.68
2710,27,10,289,190,65.74,99,34.26
2711,27,11,497,330,66.4,167,33.6
2712,27,12,340,247,72.65,93,27.35
2713,27,13,575,330,57.39,245,42.61
2714,27,14,204,116,56.86,88,43.14
2715,27,15,194,108,55.67,86,44.33
2716,27,16,481,291,60.5,190,39.5
2717,27,17,434,236,54.38,198,45.62
2718,27,18,274,149,54.38,125,45.62
2719,27,19,200,111,55.5,89,44.5
2720,27,20,293,157,53.58,136,46.42
2721,27,21,391,260,66.5,131,33.5
2722,27,22,172,96,55.81,76,44.19
2723,27,23,243,155,63.79,88,36.21
2724,27,24,265,158,59.62,107,40.38
2725,27,25,384,208,54.17,176,45.83
2726,27,26,274,135,49.27,139,50.73
2727,27,27,542,309,57.01,233,42.99
2728,27,28,541,368,68.02,173,31.98
2729,27,29,264,141,53.41,123,46.59
2730,27,30,180,91,50.56,89,49.44
2731,27,31,300,180,60.0,120,40.0
2732,27,32,388,223,57.47,165,42.53
2733,27,33,584,361,61.82,223,38.18
2734,27,34,215,126,58.6,89,41.4
2735,27,35,556,323,58.09,233,41.91
2736,27,36,300,156,52.0,144,48.0
2737,27,37,386,235,60.88,151,39.12
2738,27,38,547,346,63.25,201,36.75
2739,27,39,288,136,47.22,152,52.78
2740,27,40,580,333,57.41,247,42.59
2741,27,41,298,176,59.06,122,40.94
2742,27,42,271,157,57.93,114,42.07
2743,27,43,342,211,61.7,131,38.3
2744,27,44,274,141,51.46,133,48.54
2745,27,45,1197,753,62.91,444,37.09
2746,27,46,376,259,68.88,117,31.12
2747,27,47,250,160,64.0,90,36.0
2748,27,48,737,464,62.96,273,37.04
2749,27,49,293,166,56.66,127,43.34
2750,27,50,354,178,50.28,176,49.72
2801,28,1,224,126,56.25,98,43.75
2802,28,2,287,158,55.05,129,44.95
2803,28,3,242,128,52.89,114,47.11
2804,28,4,316,188,59.49,128,40.51
2805,28,5,193,119,61.66,74,38.34
2806,28,6,179,118,65.92,61,34.08
2807,28,7,322,170,52.8,152,47.2
2808,28,8,518,330,63.71,188,36.29
2809,28,9,316,173,54.75,143,45.25
2810,28,10,428,240,56.07,188,43.93
2811,28,11,753,389,51.66,364,48.34
2812,28,12,284,188,66.2,96,33.8
2813,28,13,310,196,63.23,114,36.77
2814,28,14,289,162,56.06,127,43.94
2815,28,15,59,37,62.71,22,37.29
2816,28,16,204,107,52.45,97,47.55
2817,28,17,266,158,59.4,108,40.6
2818,28,18,253,145,57.31,108,42.69
2819,28,19,299,164,54.85,135,45.15
2820,28,20,260,149,57.31,111,42.69
2821,28,21,270,148,54.81,122,45.19
2822,28,22,292,144,49.32,148,50.68
2823,28,23,362,217,59.94,145,40.06
2824,28,24,279,161,57.71,118,42.29
2825,28,25,466,260,55.79,206,44.21
2826,28,26,297,165,55.56,132,44.44
2827,28,27,359,214,59.61,145,40.39
2828,28,28,440,269,61.14,171,38.86
2829,28,29,171,102,59.65,69,40.35
2830,28,30,49,29,59.18,20,40.82
2831,28,31,329,200,60.79,129,39.21
2832,28,32,302,167,55.3,135,44.7
2833,28,33,339,186,54.87,153,45.13
2834,28,34,560,279,49.82,281,50.18
2835,28,35,351,181,51.57,170,48.43
2836,28,36,159,83,52.2,76,47.8
2837,28,37,345,178,51.59,167,48.41
2838,28,38,133,92,69.17,41,30.83
2839,28,39,240,131,54.58,109,45.42
2840,28,40,408,237,58.09,171,41.91
2841,28,41,202,114,56.44,88,43.56
2842,28,42,307,173,56.35,134,43.65
2843,28,43,363,204,56.2,159,43.8
2844,28,44,235,135,57.45,100,42.55
2845,28,45,491,284,57.84,207,42.16
2846,28,46,624,335,53.69,289,46.31
2901,29,1,559,330,59.03,229,40.97
2902,29,2,460,271,58.91,189,41.09
2903,29,3,340,200,58.82,140,41.18
2904,29,4,449,282,62.81,167,37.19
2905,29,5,292,170,58.22,122,41.78
2906,29,6,283,176,62.19,107,37.81
2907,29,7,420,239,56.9,181,43.1
2908,29,8,368,225,61.14,143,38.86
2909,29,9,451,292,64.75,159,35.25
2910,29,10,523,317,60.61,206,39.39
2911,29,11,214,133,62.15,81,37.85
2912,29,12,484,284,58.68,200,41.32
2913,29,13,386,213,55.18,173,44.82
2914,29,14,333,195,58.56,138,41.44
2915,29,15,445,254,57.08,191,42.92
2916,29,16,359,233,64.9,126,35.1
2917,29,17,380,195,51.32,185,48.68
2918,29,18,350,202,57.71,148,42.29
2919,29,19,372,197,52.96,175,47.04
2920,29,20,403,213,52.85,190,47.15
2921,29,21,467,267,57.17,200,42.83
2922,29,22,292,165,56.51,127,43.49
2923,29,23,479,295,61.59,184,38.41
2924,29,24,380,231,60.79,149,39.21
2925,29,25,444,274,61.71,170,38.29
2926,29,26,364,216,59.34,148,40.66
2927,29,27,352,203,57.67,149,42.33
2928,29,28,455,273,60.0,182,40.0
2929,29,29,473,299,63.21,174,36.79
2930,29,30,558,343,61.47,215,38.53
2931,29,31,446,289,64.8,157,35.2
2932,29,32,435,297,68.28,138,31.72
2933,29,33,270,151,55.93,119,44.07
2934,29,34,284,167,58.8,117,41.2
2935,29,35,294,152,51.7,142,48.3
2936,29,36,354,209,59.04,145,40.96
2937,29,37,368,203,55.16,165,44.84
2938,29,38,503,318,63.22,185,36.78
2939,29,39,445,309,69.44,136,30.56
2940,29,40,440,284,64.55,156,35.45
2941,29,41,326,190,58.28,136,41.72
2942,29,42,415,232,55.9,183,44.1
2943,29,43,493,296,60.04,197,39.96
2944,29,44,434,235,54.15,199,45.85
3001,30,1,497,318,63.98,179,36.02
3002,30,2,442,297,67.19,145,32.81
3003,30,3,370,208,56.22,162,43.78
3004,30,4,434,277,63.82,157,36.18
3005,30,5,356,245,68.82,111,31.18
3006,30,6,308,213,69.16,95,30.84
3007,30,7,507,287,56.61,220,43.39
3008,30,8,559,287,51.34,272,48.66
3009,30,9,375,229,61.07,146,38.93
3010,30,10,411,285,69.34,126,30.66
3011,30,11,438,291,66.44,147,33.56
3012,30,12,411,268,65.21,143,34.79
3013,30,13,466,306,65.67,160,34.33
3014,30,14,326,205,62.88,121,37.12
3015,30,15,406,234,57.64,172,42.36
3016,30,16,248,148,59.68,100,40.32
3017,30,17,452,285,63.05,167,36.95
3018,30,18,565,299,52.92,266,47.08
3019,30,19,474,306,64.56,168,35.44
3020,30,20,470,268,57.02,202,42.98
3021,30,21,326,205,62.88,121,37.12
3022,30,22,672,364,54.17,308,45.83
3023,30,23,573,316,55.15,257,44.85
3024,30,24,656,292,44.51,364,55.49
3025,30,25,693,345,49.78,348,50.22
3026,30,26,278,177,63.67,101,36.33
3027,30,27,324,208,64.2,116,35.8
3028,30,28,472,257,54.45,215,45.55
3029,30,29,322,202,62.73,120,37.27
3030,30,30,200,135,67.5,65,32.5
3031,30,31,284,167,58.8,117,41.2
3032,30,32,364,212,58.24,152,41.76
3101,31,1,290,164,56.55,126,43.45
3102,31,2,272,175,64.34,97,35.66
3103,31,3,288,185,64.24,103,35.76
3104,31,4,396,183,46.21,213,53.79
3105,31,5,322,191,59.32,131,40.68
3106,31,6,215,131,60.93,84,39.07
3107,31,7,439,222,50.57,217,49.43
3108,31,8,285,186,65.26,99,34.74
3109,31,9,342,220,64.33,122,35.67
3110,31,10,352,217,61.65,135,38.35
3111,31,11,241,154,63.9,87,36.1
3112,31,12,262,161,61.45,101,38.55
3113,31,13,322,194,60.25,128,39.75
3114,31,14,298,203,68.12,95,31.88
3115,31,15,314,190,60.51,124,39.49
3116,31,16,371,147,39.62,224,60.38
3117,31,17,289,203,70.24,86,29.76
3118,31,18,281,185,65.84,96,34.16
3119,31,19,277,166,59.93,111,40.07
3120,31,20,262,151,57.63,111,42.37
3121,31,21,280,190,67.86,90,32.14
3122,31,22,261,149,57.09,112,42.91
3123,31,23,329,197,59.88,132,40.12
3124,31,24,304,185,60.86,119,39.14
3125,31,25,309,195,63.11,114,36.89
3126,31,26,295,186,63.05,109,36.95
3127,31,27,329,208,63.22,121,36.78
3128,31,28,281,169,60.14,112,39.86
3129,31,29,293,184,62.8,109,37.2
3130,31,30,248,158,63.71,90,36.29
3131,31,31,266,176,66.17,90,33.83
3132,31,32,245,158,64.49,87,35.51
3133,31,33,295,188,63.73,107,36.27
3134,31,34,304,193,63.49,111,36.51
3135,31,35,372,232,62.37,140,37.63
3136,31,36,308,174,56.49,134,43.51
3137,31,37,292,188,64.38,104,35.62
3138,31,38,285,181,63.51,104,36.49
3139,31,39,349,184,52.72,165,47.28
3140,31,40,353,176,49.86,177,50.14
3141,31,41,289,178,61.59,111,38.41
3201,32,1,690,415,60.14,275,39.86
3202,32,2,616,360,58.44,256,41.56
3203,32,3,595,305,51.26,290,48.74
3204,32,4,503,290,57.65,213,42.35
3205,32,5,587,334,56.9,253,43.1
3206,32,6,653,410,62.79,243,37.21
3207,32,7,618,381,61.65,237,38.35
3208,32,8,674,445,66.02,229,33.98
3209,32,9,564,320,56.74,244,43.26
3210,32,10,613,370,60.36,243,39.64
3211,32,11,495,202,40.81,293,59.19
3212,32,12,380,170,44.74,210,55.26
3213,32,13,618,395,63.92,223,36.08
3214,32,14,590,271,45.93,319,54.07
3215,32,15,516,307,59.5,209,40.5
3216,32,16,531,286,53.86,245,46.14
3217,32,17,550,253,46.0,297,54.0
3218,32,18,544,383,70.4,161,29.6
3219,32,19,511,284,55.58,227,44.42
3220,32,20,526,247,46.96,279,53.04
3221,32,21,562,353,62.81,209,37.19
3222,32,22,690,302,43.77,388,56.23
3223,32,23,591,365,61.76,226,38.24
3224,32,24,484,336,69.42,148,30.58
3225,32,25,549,381,69.4,168,30.6
3226,32,26,579,277,47.84,302,52.16
3227,32,27,567,366,64.55,201,35.45
3228,32,28,568,271,47.71,297,52.29
3229,32,29,598,329,55.02,269,44.98
3230,32,30,546,371,67.95,175,32.05
3231,32,31,605,375,61.98,230,38.02
3232,32,32,643,402,62.52,241,37.48
3233,32,33,491,305,62.12,186,37.88
3234,32,34,613,348,56.77,265,43.23
3235,32,35,526,330,62.74,196,37.26
3236,32,36,592,357,60.3,235,39.7
3237,32,37,644,378,58.7,266,41.3
3238,32,38,538,306,56.88,232,43.12
3239,32,39,629,451,71.7,178,28.3
3240,32,40,565,373,66.02,192,33.98
3241,32,41,576,361,62.67,215,37.33
3242,32,42,510,325,63.73,185,36.27
3243,32,43,492,198,40.24,294,59.76
3301,33,1,610,321,52.62,289,47.38
3302,33,2,747,404,54.08,343,45.92
3303,33,3,791,402,50.82,389,49.18
3304,33,4,770,401,52.08,369,47.92
3305,33,5,550,318,57.82,232,42.18
3306,33,6,497,289,58.15,208,41.85
3307,33,7,587,331,56.39,256,43.61
3308,33,8,733,420,57.3,313,42.7
3309,33,9,650,392,60.31,258,39.69
3310,33,10,487,305,62.63,182,37.37
3311,33,11,590,349,59.15,241,40.85
3312,33,12,589,328,55.69,261,44.31
3313,33,13,571,284,49.74,287,50.26
3314,33,14,278,162,58.27,116,41.73
3315,33,15,610,323,52.95,287,47.05
3316,33,16,789,468,59.32,321,40.68
3317,33,17,603,352,58.37,251,41.63
3318,33,18,833,440,52.82,393,47.18
3319,33,19,693,384,55.41,309,44.59
3320,33,20,733,389,53.07,344,46.93
3321,33,21,634,337,53.15,297,46.85
3322,33,22,547,345,63.07,202,36.93
3323,33,23,649,353,54.39,296,45.61
3324,33,24,695,399,57.41,296,42.59
3325,33,25,687,417,60.7,270,39.3
3326,33,26,443,212,47.86,231,52.14
3327,33,27,683,368,53.88,315,46.12
3328,33,28,536,239,44.59,297,55.41
3401,34,1,418,188,44.98,230,55.02
3402,34,2,334,163,48.8,171,51.2
3403,34,3,381,195,51.18,186,48.82
3404,34,4,297,171,57.58,126,42.42
3405,34,5,324,181,55.86,143,44.14
3406,34,6,428,212,49.53,216,50.47
3407,34,7,399,205,51.38,194,48.62
3408,34,8,322,170,52.8,152,47.2
3409,34,9,268,130,48.51,138,51.49
3410,34,10,320,148,46.25,172,53.75
3411,34,11,336,181,53.87,155,46.13
3412,34,12,401,208,51.87,193,48.13
3413,34,13,393,204,51.91,189,48.09
3414,34,14,291,177,60.82,114,39.18
3415,34,15,360,211,58.61,149,41.39
3416,34,16,342,187,54.68,155,45.32
3417,34,17,460,252,54.78,208,45.22
3418,34,18,245,141,57.55,104,42.45
3419,34,19,407,228,56.02,179,43.98
3420,34,20,434,235,54.15,199,45.85
3421,34,21,442,201,45.48,241,54.52
3422,34,22,384,183,47.66,201,52.34
3423,34,23,324,155,47.84,169,52.16
3424,34,24,324,166,51.23,158,48.77
3425,34,25,568,269,47.36,299,52.64
3426,34,26,443,219,49.44,224,50.56
3427,34,27,314,174,55.41,140,44.59
3428,34,28,240,156,65.0,84,35.0
3429,34,29,295,148,50.17,147,49.83
3430,34,30,368,192,52.17,176,47.83
3431,34,31,293,159,54.27,134,45.73
3432,34,32,363,193,53.17,170,46.83
3433,34,33,321,174,54.21,147,45.79
3434,34,34,453,220,48.57,233,51.43
3435,34,35,472,228,48.31,244,51.69
3436,34,36,336,171,50.89,165,49.11
3437,34,37,220,107,48.64,113,51.36
3438,34,38,190,101,53.16,89,46.84
3439,34,39,275,138,50.18,137,49.82
3440,34,40,399,194,48.62,205,51.38
3441,34,41,229,115,50.22,114,49.78
3442,34,42,374,188,50.27,186,49.73
3443,34,43,350,142,40.57,208,59.43
3444,34,44,343,158,46.06,185,53.94
3445,34,45,378,197,52.12,181,47.88
3446,34,46,261,132,50.57,129,49.43
3447,34,47,344,185,53.78,159,46.22
3448,34,48,381,175,45.93,206,54.07
3449,34,49,344,182,52.91,162,47.09
3450,34,50,305,176,57.7,129,42.3
3451,34,51,424,208,49.06,216,50.94
3452,34,52,303,160,52.81,143,47.19
3453,34,53,268,128,47.76,140,52.24
3501,35,1,499,251,50.3,248,49.7
3502,35,2,523,240,45.89,283,54.11
3503,35,3,444,224,50.45,220,49.55
3504,35,4,499,285,57.11,214,42.89
3505,35,5,425,214,50.35,211,49.65
3506,35,6,526,284,53.99,242,46.01
3507,35,7,510,210,41.18,300,58.82
3508,35,8,502,241,48.01,261,51.99
3509,35,9,433,246,56.81,187,43.19
3510,35,10,578,236,40.83,342,59.17
3511,35,11,562,295,52.49,267,47.51
3512,35,12,338,206,60.95,132,39.05
3513,35,13,347,213,61.38,134,38.62
3514,35,14,395,225,56.96,170,43.04
3515,35,15,608,293,48.19,315,51.81
3516,35,16,266,163,61.28,103,38.72
3517,35,17,490,223,45.51,267,54.49
3518,35,18,334,203,60.78,131,39.22
3519,35,19,298,178,59.73,120,40.27
3520,35,20,493,308,62.47,185,37.53
3521,35,21,499,254,50.9,245,49.1
3522,35,22,609,312,51.23,297,48.77
3523,35,23,498,287,57.63,211,42.37
3524,35,24,448,249,55.58,199,44.42
3525,35,25,515,228,44.27,287,55.73
3526,35,26,423,237,56.03,186,43.97
3527,35,27,440,242,55.0,198,45.0
3528,35,28,495,230,46.46,265,53.54
3529,35,29,477,284,59.54,193,40.46
3530,35,30,448,246,54.91,202,45.09
3531,35,31,526,304,57.79,222,42.21
3601,36,1,412,280,67.96,132,32.04
3602,36,2,408,252,61.76,156,38.24
3603,36,3,379,236,62.27,143,37.73
3604,36,4,461,305,66.16,156,33.84
3605,36,5,384,250,65.1,134,34.9
3606,36,6,367,222,60.49,145,39.51
3607,36,7,439,280,63.78,159,36.22
3608,36,8,338,210,62.13,128,37.87
3609,36,9,404,248,61.39,156,38.61
3610,36,10,554,373,67.33,181,32.67
3611,36,11,294,173,58.84,121,41.16
3612,36,12,262,158,60.31,104,39.69
3613,36,13,291,181,62.2,110,37.8
3614,36,14,456,272,59.65,184,40.35
3615,36,15,432,293,67.82,139,32.18
3616,36,16,428,276,64.49,152,35.51
3617,36,17,512,329,64.26,183,35.74
3618,36,18,441,266,60.32,175,39.68
3619,36,19,542,342,63.1,200,36.9
3620,36,20,481,313,65.07,168,34.93
3621,36,21,375,232,61.87,143,38.13
3622,36,22,381,222,58.27,159,41.73
3623,36,23,374,224,59.89,150,40.11
3624,36,24,488,306,62.7,182,37.3
3625,36,25,435,278,63.91,157,36.09
3626,36,26,409,271,66.26,138,33.74
3627,36,27,370,241,65.14,129,34.86
3628,36,28,400,266,66.5,134,33.5
3629,36,29,456,299,65.57,157,34.43
3630,36,30,398,240,60.3,158,39.7
3701,37,1,208,148,71.15,60,28.85
3702,37,2,302,186,61.59,116,38.41
3703,37,3,241,135,56.02,106,43.98
3704,37,4,287,173,60.28,114,39.72
3705,37,5,351,201,57.26,150,42.74
3706,37,6,232,138,59.48,94,40.52
3707,37,7,275,178,64.73,97,35.27
3708,37,8,246,148,60.16,98,39.84
3709,37,9,326,206,63.19,120,36.81
3710,37,10,427,259,60.66,168,39.34
3711,37,11,223,121,54.26,102,45.74
3712,37,12,313,186,59.42,127,40.58
3713,37,13,257,167,64.98,90,35.02
3714,37,14,381,215,56.43,166,43.57
3715,37,15,349,206,59.03,143,40.97
3716,37,16,368,217,58.97,151,41.03
3717,37,17,255,157,61.57,98,38.43
3718,37,18,292,178,60.96,114,39.04
3719,37,19,258,151,58.53,107,41.47
3720,37,20,306,204,66.67,102,33.33
3721,37,21,276,179,64.86,97,35.14
3722,37,22,306,186,60.78,120,39.22
3723,37,23,331,195,58.91,136,41.09
3724,37,24,321,194,60.44,127,39.56
3725,37,25,290,159,54.83,131,45.17
3726,37,26,457,257,56.24,200,43.76
3727,37,27,320,187,58.44,133,41.56
3728,37,28,296,182,61.49,114,38.51
3729,37,29,291,177,60.82,114,39.18
3730,37,30,313,199,63.58,114,36.42
3731,37,31,389,233,59.9,156,40.1
3732,37,32,305,189,61.97,116,38.03
3733,37,33,253,144,56.92,109,43.08
3734,37,34,290,172,59.31,118,40.69
3735,37,35,341,202,59.24,139,40.76
3736,37,36,241,135,56.02,106,43.98
3737,37,37,351,215,61.25,136,38.75
3738,37,38,360,199,55.28,161,44.72
3739,37,39,279,169,60.57,110,39.43
3740,37,40,346,213,61.56,133,38.44
3741,37,41,342,218,63.74,124,36.26
3801,38,1,407,262,64.37,145,35.63
3802,38,2,425,290,68.24,135,31.76
3803,38,3,455,271,59.56,184,40.44
3804,38,4,417,272,65.23,145,34.77
3805,38,5,413,264,63.92,149,36.08
3806,38,6,439,285,64.92,154,35.08
3807,38,7,417,267,64.03,150,35.97
3808,38,8,429,279,65.03,150,34.97
3809,38,9,507,340,67.06,167,32.94
3810,38,10,386,257,66.58,129,33.42
3811,38,11,385,259,67.27,126,32.73
3812,38,12,398,268,67.34,130,32.66
3813,38,13,487,308,63.24,179,36.76
3814,38,14,460,285,61.96,175,38.04
3815,38,15,402,260,64.68,142,35.32
3816,38,16,426,270,63.38,156,36.62
3817,38,17,513,324,63.16,189,36.84
3818,38,18,459,306,66.67,153,33.33
3819,38,19,469,340,72.49,129,27.51
3820,38,20,448,297,66.29,151,33.71
3821,38,21,416,255,61.3,161,38.7
3822,38,22,389,242,62.21,147,37.79
3823,38,23,465,280,60.22,185,39.78
3824,38,24,447,304,68.01,143,31.99
3825,38,25,398,261,65.58,137,34.42
3826,38,26,444,315,70.95,129,29.05
3827,38,27,441,267,60.54,174,39.46
3828,38,28,525,336,64.0,189,36.0
3829,38,29,441,282,63.95,159,36.05
3830,38,30,444,290,65.32,154,34.68
3831,38,31,450,291,64.67,159,35.33
3832,38,32,428,264,61.68,164,38.32
3833,38,33,354,217,61.3,137,38.7
3834,38,34,395,212,53.67,183,46.33
3835,38,35,408,253,62.01,155,37.99
3836,38,36,407,265,65.11,142,34.89
3837,38,37,416,247,59.38,169,40.63
3838,38,38,419,278,66.35,141,33.65
3839,38,39,471,287,60.93,184,39.07
3840,38,40,438,277,63.24,161,36.76
3841,38,41,390,221,56.67,169,43.33
3901,39,1,432,310,71.76,122,28.24
3902,39,2,316,224,70.89,92,29.11
3903,39,3,499,303,60.72,196,39.28
3904,39,4,436,292,66.97,144,33.03
3905,39,5,470,287,61.06,183,38.94
3906,39,6,471,277,58.81,194,41.19
3907,39,7,404,263,65.1,141,34.9
3908,39,8,451,293,64.97,158,35.03
3909,39,9,407,271,66.58,136,33.42
3910,39,10,213,124,58.22,89,41.78
3911,39,11,422,272,64.45,150,35.55
3912,39,12,600,324,54.0,276,46.0
3913,39,13,379,247,65.17,132,34.83
3914,39,14,463,280,60.48,183,39.52
3915,39,15,515,373,72.43,142,27.57
3916,39,16,407,264,64.86,143,35.14
3917,39,17,455,271,59.56,184,40.44
3918,39,18,446,274,61.43,172,38.57
3919,39,19,437,247,56.52,190,43.48
3920,39,20,570,364,63.86,206,36.14
3921,39,21,452,290,64.16,162,35.84
3922,39,22,434,274,63.13,160,36.87
3923,39,23,468,301,64.32,167,35.68
3924,39,24,560,371,66.25,189,33.75
3925,39,25,375,221,58.93,154,41.07
3926,39,26,413,260,62.95,153,37.05
3927,39,27,65,49,75.38,16,24.62
3928,39,28,556,328,58.99,228,41.01
3929,39,29,233,135,57.94,98,42.06
3930,39,30,556,345,62.05,211,37.95
3931,39,31,388,236,60.82,152,39.18
3932,39,32,347,231,66.57,116,33.43
3933,39,33,463,294,63.5,169,36.5
3934,39,34,534,282,52.81,252,47.19
3935,39,35,454,277,61.01,177,38.99
3936,39,36,107,79,73.83,28,26.17
3937,39,37,412,313,75.97,99,24.03
3938,39,38,233,165,70.82,68,29.18
3939,39,39,274,191,69.71,83,30.29
3940,39,40,453,298,65.78,155,34.22
3941,39,41,461,302,65.51,159,34.49
3942,39,42,481,372,77.34,109,22.66
3943,39,43,462,299,64.72,163,35.28
3944,39,44,373,261,69.97,112,30.03
3945,39,45,410,291,70.98,119,29.02
4001,40,1,448,273,60.94,175,39.06
4002,40,2,528,336,63.64,192,36.36
4003,40,3,634,313,49.37,321,50.63
4004,40,4,315,200,63.49,115,36.51
4005,40,5,568,322,56.69,246,43.31
4006,40,6,606,279,46.04,327,53.96
4007,40,7,493,258,52.33,235,47.67
4008,40,8,682,352,51.61,330,48.39
4009,40,9,405,249,61.48,156,38.52
4010,40,10,565,351,62.12,214,37.88
4011,40,11,532,289,54.32,243,45.68
4012,40,12,434,266,61.29,168,38.71
4013,40,13,755,328,43.44,427,56.56
4014,40,14,470,296,62.98,174,37.02
4015,40,15,502,314,62.55,188,37.45
4016,40,16,690,315,45.65,375,54.35
4017,40,17,428,241,56.31,187,43.69
4018,40,18,403,264,65.51,139,34.49
4019,40,19,624,361,57.85,263,42.15
4020,40,20,522,304,58.24,218,41.76
4021,40,21,597,352,58.96,245,41.04
4022,40,22,634,369,58.2,265,41.8
4023,40,23,611,320,52.37,291,47.63
4024,40,24,479,309,64.51,170,35.49
4025,40,25,596,295,49.5,301,50.5
4026,40,26,554,263,47.47,291,52.53
4027,40,27,628,326,51.91,302,48.09
4028,40,28,551,271,49.18,280,50.82
4029,40,29,556,349,62.77,207,37.23
4030,40,30,432,266,61.57,166,38.43
4031,40,31,585,299,51.11,286,48.89
4032,40,32,561,291,51.87,270,48.13
4033,40,33,505,263,52.08,242,47.92
4034,40,34,458,291,63.54,167,36.46
4035,40,35,357,229,64.15,128,35.85
4036,40,36,446,251,56.28,195,43.72
4037,40,37,532,307,57.71,225,42.29
4038,40,38,641,308,48.05,333,51.95
4039,40,39,199,148,74.37,51,25.63
4101,41,1,469,297,63.33,172,36.67
4102,41,2,528,377,71.4,151,28.6
4103,41,3,471,309,65.61,162,34.39
4104,41,4,478,352,73.64,126,26.36
4105,41,5,560,357,63.75,203,36.25
4106,41,6,549,413,75.23,136,24.77
4107,41,7,500,343,68.6,157,31.4
4108,41,8,485,316,65.15,169,34.85
4109,41,9,421,290,68.88,131,31.12
4110,41,10,506,376,74.31,130,25.69
4111,41,11,533,356,66.79,177,33.21
4112,41,12,500,333,66.6,167,33.4
4113,41,13,542,355,65.5,187,34.5
4114,41,14,510,349,68.43,161,31.57
4115,41,15,612,440,71.9,172,28.1
4116,41,16,463,299,64.58,164,35.42
4117,41,17,434,285,65.67,149,34.33
4118,41,18,452,291,64.38,161,35.62
4119,41,19,500,373,74.6,127,25.4
4120,41,20,347,232,66.86,115,33.14
4121,41,21,489,335,68.51,154,31.49
4122,41,22,558,375,67.2,183,32.8
4123,41,23,499,364,72.95,135,27.05
4124,41,24,458,301,65.72,157,34.28
4125,41,25,422,273,64.69,149,35.31
4126,41,26,435,286,65.75,149,34.25
4127,41,27,399,263,65.91,136,34.09
4128,41,28,454,293,64.54,161,35.46
4129,41,29,379,239,63.06,140,36.94
4130,41,30,415,271,65.3,144,34.7
4131,41,31,426,306,71.83,120,28.17
4132,41,32,404,281,69.55,123,30.45
4133,41,33,472,336,71.19,136,28.81
4134,41,34,453,295,65.12,158,34.88
4135,41,35,560,366,65.36,194,34.64
4136,41,36,489,292,59.71,197,40.29
4137,41,37,538,384,71.38,154,28.62
4138,41,38,463,288,62.2,175,37.8
4139,41,39,490,313,63.88,177,36.12
4140,41,40,547,362,66.18,185,33.82
4141,41,41,520,368,70.77,152,29.23
4142,41,42,479,325,67.85,154,32.15
4143,41,43,488,330,67.62,158,32.38
4144,41,44,500,348,69.6,152,30.4
4145,41,45,473,302,63.85,171,36.15
4146,41,46,489,325,66.46,164,33.54
4147,41,47,492,337,68.5,155,31.5
4201,42,1,464,355,76.51,109,23.49
4202,42,2,643,448,69.67,195,30.33
4203,42,3,566,370,65.37,196,34.63
4204,42,4,1257,886,70.49,371,29.51
4205,42,5,426,305,71.6,121,28.4
4206,42,6,510,353,69.22,157,30.78
4207,42,7,634,471,74.29,163,25.71
4208,42,8,433,274,63.28,159,36.72
4209,42,9,712,463,65.03,249,34.97
4210,42,10,766,515,67.23,251,32.77
4211,42,11,347,269,77.52,78,22.48
4212,42,12,450,344,76.44,106,23.56
4213,42,13,426,304,71.36,122,28.64
4214,42,14,718,521,72.56,197,27.44
4215,42,15,724,510,70.44,214,29.56
4216,42,16,531,358,67.42,173,32.58
4217,42,17,858,591,68.88,267,31.12
4218,42,18,683,456,66.76,227,33.24
4219,42,19,683,529,77.45,154,22.55
4220,42,20,647,439,67.85,208,32.15
4221,42,21,668,457,68.41,211,31.59
4222,42,22,306,219,71.57,87,28.43
4223,42,23,573,407,71.03,166,28.97
4224,42,24,512,383,74.8,129,25.2
4225,42,25,604,402,66.56,202,33.44
4226,42,26,846,614,72.58,232,27.42
4227,42,27,362,224,61.88,138,38.12
4228,42,28,585,393,67.18,192,32.82
4229,42,29,638,438,68.65,200,31.35
4230,42,30,422,322,76.3,100,23.7
4231,42,31,631,452,71.63,179,28.37
4232,42,32,629,417,66.3,212,33.7
4233,42,33,606,388,64.03,218,35.97
4234,42,34,439,325,74.03,114,25.97
4235,42,35,659,444,67.37,215,32.63
4236,42,36,967,597,61.74,370,38.26
4237,42,37,425,289,68.0,136,32.0
4238,42,38,530,374,70.57,156,29.43
4239,42,39,926,662,71.49,264,28.51
4240,42,40,784,549,70.03,235,29.97
4241,42,41,565,385,68.14,180,31.86
4242,42,42,943,657,69.67,286,30.33
4301,43,1,271,187,69.0,84,31.0
4302,43,2,568,383,67.43,185,32.57
4303,43,3,499,344,68.94,155,31.06
4304,43,4,606,416,68.65,190,31.35
4305,43,5,483,337,69.77,146,30.23
4306,43,6,421,276,65.56,145,34.44
4307,43,7,305,205,67.21,100,32.79
4308,43,8,405,296,73.09,109,26.91
4309,43,9,525,352,67.05,173,32.95
4310,43,10,638,443,69.44,195,30.56
4311,43,11,504,330,65.48,174,34.52
4312,43,12,340,237,69.71,103,30.29
4313,43,13,530,331,62.45,199,37.55
4314,43,14,546,395,72.34,151,27.66
4315,43,15,505,334,66.14,171,33.86
4316,43,16,705,447,63.4,258,36.6
4317,43,17,425,320,75.29,105,24.71
4318,43,18,589,408,69.27,181,30.73
4319,43,19,514,360,70.04,154,29.96
4320,43,20,648,448,69.14,200,30.86
4321,43,21,599,374,62.44,225,37.56
4322,43,22,371,241,64.96,130,35.04
4323,43,23,375,252,67.2,123,32.8
4324,43,24,400,274,68.5,126,31.5
4325,43,25,432,303,70.14,129,29.86
4326,43,26,325,225,69.23,100,30.77
4327,43,27,496,341,68.75,155,31.25
4328,43,28,645,470,72.87,175,27.13
4329,43,29,748,505,67.51,243,32.49
4330,43,30,555,376,67.75,179,32.25
4331,43,31,489,338,69.12,151,30.88
4332,43,32,534,366,68.54,168,31.46
4333,43,33,499,386,77.35,113,22.65
4334,43,34,356,240,67.42,116,32.58
4335,43,35,573,429,74.87,144,25.13
4336,43,36,334,215,64.37,119,35.63
4337,43,37,623,380,61.0,243,39.0
4338,43,38,389,283,72.75,106,27.25
4339,43,39,395,235,59.49,160,40.51
4340,43,40,397,246,61.96,151,38.04
4341,43,41,655,431,65.8,224,34.2
4342,43,42,496,302,60.89,194,39.11
4343,43,43,516,413,80.04,103,19.96
4344,43,44,524,337,64.31,187,35.69
4345,43,45,329,228,69.3,101,30.7
4346,43,46,328,211,64.33,117,35.67
4401,44,1,873,530,60.71,343,39.29
4402,44,2,574,384,66.9,190,33.1
4403,44,3,308,220,71.43,88,28.57
4404,44,4,430,302,70.23,128,29.77
4405,44,5,574,368,64.11,206,35.89
4406,44,6,723,411,56.85,312,43.15
4407,44,7,355,253,71.27,102,28.73
4408,44,8,779,451,57.89,328,42.11
4409,44,9,601,389,64.73,212,35.27
4410,44,10,610,387,63.44,223,36.56
4411,44,11,674,391,58.01,283,41.99
4412,44,12,593,378,63.74,215,36.26
4413,44,13,495,331,66.87,164,33.13
4414,44,14,570,366,64.21,204,35.79
4415,44,15,543,345,63.54,198,36.46
4416,44,16,667,398,59.67,269,40.33
4417,44,17,766,472,61.62,294,38.38
4418,44,18,626,399,63.74,227,36.26
4419,44,19,685,428,62.48,257,37.52
4420,44,20,731,421,57.59,310,42.41
4421,44,21,662,415,62.69,247,37.31
4422,44,22,564,359,63.65,205,36.35
4423,44,23,565,350,61.95,215,38.05
4424,44,24,389,279,71.72,110,28.28
4425,44,25,584,380,65.07,204,34.93
4426,44,26,761,416,54.66,345,45.34
4427,44,27,686,435,63.41,251,36.59
4428,44,28,625,375,60.0,250,40.0
4429,44,29,686,422,61.52,264,38.48
4430,44,30,711,440,61.88,271,38.12
4431,44,31,534,313,58.61,221,41.39
4432,44,32,689,407,59.07,282,40.93
4433,44,33,647,363,56.11,284,43.89
4434,44,34,598,387,64.72,211,35.28
4435,44,35,614,403,65.64,211,34.36
4436,44,36,673,418,62.11,255,37.89
4437,44,37,665,394,59.25,271,40.75
4438,44,38,724,451,62.29,273,37.71
4439,44,39,629,414,65.82,215,34.18
4440,44,40,562,347,61.74,215,38.26
4441,44,41,751,450,59.92,301,40.08
4501,45,1,399,212,53.13,187,46.87
4502,45,2,489,257,52.56,232,47.44
4503,45,3,420,248,59.05,172,40.95
4504,45,4,565,330,58.41,235,41.59
4505,45,5,490,335,68.37,155,31.63
4506,45,6,626,381,60.86,245,39.14
4507,45,7,667,417,62.52,250,37.48
4508,45,8,471,307,65.18,164,34.82
4509,45,9,467,281,60.17,186,39.83
4510,45,10,455,270,59.34,185,40.66
4511,45,11,356,205,57.58,151,42.42
4512,45,12,434,244,56.22,190,43.78
4513,45,13,386,233,60.36,153,39.64
4514,45,14,650,414,63.69,236,36.31
4515,45,15,564,330,58.51,234,41.49
4516,45,16,402,242,60.2,160,39.8
4517,45,17,509,308,60.51,201,39.49
4518,45,18,514,332,64.59,182,35.41
4519,45,19,266,177,66.54,89,33.46
4520,45,20,334,198,59.28,136,40.72
4521,45,21,412,244,59.22,168,40.78
4522,45,22,431,288,66.82,143,33.18
4523,45,23,453,276,60.93,177,39.07
4524,45,24,369,235,63.69,134,36.31
4525,45,25,307,207,67.43,100,32.57
4526,45,26,274,177,64.6,97,35.4
4527,45,27,446,294,65.92,152,34.08
4528,45,28,377,239,63.4,138,36.6
4529,45,29,301,198,65.78,103,34.22
4530,45,30,456,276,60.53,180,39.47
4531,45,31,374,252,67.38,122,32.62
4532,45,32,437,269,61.56,168,38.44
4533,45,33,325,188,57.85,137,42.15
4534,45,34,480,310,64.58,170,35.42
4535,45,35,498,315,63.25,183,36.75
4536,45,36,485,307,63.3,178,36.7
4537,45,37,439,269,61.28,170,38.72
4538,45,38,437,277,63.39,160,36.61
4539,45,39,465,288,61.94,177,38.06
4540,45,40,439,279,63.55,160,36.45
4541,45,41,421,268,63.66,153,36.34
4542,45,42,446,296,66.37,150,33.63
4543,45,43,504,332,65.87,172,34.13
4544,45,44,419,282,67.3,137,32.7
4545,45,45,312,206,66.03,106,33.97
4546,45,46,371,231,62.26,140,37.74
4547,45,47,323,213,65.94,110,34.06
4548,45,48,359,246,68.52,113,31.48
4601,46,1,427,215,50.35,212,49.65
4602,46,2,559,291,52.06,268,47.94
4603,46,3,635,410,64.57,225,35.43
4604,46,4,530,271,51.13,259,48.87
4605,46,5,736,429,58.29,307,41.71
4606,46,6,483,261,54.04,222,45.96
4607,46,7,536,348,64.93,188,35.07
4608,46,8,388,215,55.41,173,44.59
4609,46,9,626,329,52.56,297,47.44
4610,46,10,927,557,60.09,370,39.91
4611,46,11,538,310,57.62,228,42.38
4612,46,12,600,293,48.83,307,51.17
4613,46,13,573,341,59.51,232,40.49
4614,46,14,581,350,60.24,231,39.76
4615,46,15,564,330,58.51,234,41.49
4616,46,16,641,316,49.3,325,50.7
4617,46,17,583,364,62.44,219,37.56
4618,46,18,629,385,61.21,244,38.79
4619,46,19,364,238,65.38,126,34.62
4620,46,20,479,286,59.71,193,40.29
4621,46,21,420,225,53.57,195,46.43
4622,46,22,401,190,47.38,211,52.62
4623,46,23,512,271,52.93,241,47.07
4624,46,24,690,429,62.17,261,37.83
4625,46,25,546,265,48.53,281,51.47
4626,46,26,778,414,53.21,364,46.79
4627,46,27,728,394,54.12,334,45.88
4628,46,28,509,366,71.91,143,28.09
4629,46,29,446,278,62.33,168,37.67
4630,46,30,568,333,58.63,235,41.37
4631,46,31,578,340,58.82,238,41.18
4632,46,32,516,281,54.46,235,45.54
4633,46,33,574,342,59.58,232,40.42
4634,46,34,709,387,54.58,322,45.42
4635,46,35,628,380,60.51,248,39.49
4636,46,36,511,331,64.77,180,35.23
4637,46,37,440,266,60.45,174,39.55
4638,46,38,638,366,57.37,272,42.63
4639,46,39,501,280,55.89,221,44.11
4640,46,40,470,276,58.72,194,41.28
4701,47,1,398,205,51.51,193,48.49
4702,47,2,577,363,62.91,214,37.09
4703,47,3,532,347,65.23,185,34.77
4704,47,4,693,402,58.01,291,41.99
4705,47,5,637,289,45.37,348,54.63
4706,47,6,707,386,54.6,321,45.4
4707,47,7,539,300,55.66,239,44.34
4708,47,8,572,300,52.45,272,47.55
4709,47,9,555,300,54.05,255,45.95
4710,47,10,708,310,43.79,398,56.21
4711,47,11,590,357,60.51,233,39.49
4712,47,12,637,313,49.14,324,50.86
4713,47,13,578,284,49.13,294,50.87
4714,47,14,541,316,58.41,225,41.59
4715,47,15,733,244,33.29,489,66.71
4716,47,16,594,353,59.43,241,40.57
4717,47,17,572,307,53.67,265,46.33
4718,47,18,570,318,55.79,252,44.21
4719,47,19,916,393,42.9,523,57.1
4720,47,20,609,296,48.6,313,51.4
4721,47,21,560,259,46.25,301,53.75
4722,47,22,658,318,48.33,340,51.67
4723,47,23,677,300,44.31,377,55.69
4724,47,24,625,329,52.64,296,47.36
4725,47,25,709,342,48.24,367,51.76
4726,47,26,785,351,44.71,434,55.29
4727,47,27,514,274,53.31,240,46.69
4728,47,28,536,296,55.22,240,44.78
4729,47,29,680,366,53.82,314,46.18
4730,47,30,725,362,49.93,363,50.07
4731,47,31,631,332,52.61,299,47.39
4732,47,32,729,342,46.91,387,53.09
4733,47,33,560,341,60.89,219,39.11
4734,47,34,613,312,50.9,301,49.1
4735,47,35,575,317,55.13,258,44.87
4736,47,36,683,295,43.19,388,56.81
4737,47,37,544,258,47.43,286,52.57
4738,47,38,584,284,48.63,300,51.37
4739,47,39,593,295,49.75,298,50.25
4740,47,40,541,274,50.65,267,49.35
4741,47,41,642,323,50.31,319,49.69
4742,47,42,571,256,44.83,315,55.17
4743,47,43,541,321,59.33,220,40.67
4744,47,44,498,299,60.04,199,39.96
4745,47,45,544,243,44.67,301,55.33
4746,47,46,596,329,55.2,267,44.8
4747,47,47,715,388,54.27,327,45.73
4748,47,48,31,21,67.74,10,32.26
4801,48,1,533,246,46.15,287,53.85
4802,48,2,229,133,58.08,96,41.92
4803,48,3,633,345,54.5,288,45.5
4804,48,4,504,267,52.98,237,47.02
4805,48,5,282,163,57.8,119,42.2
4806,48,6,640,351,54.84,289,45.16
4807,48,7,584,311,53.25,273,46.75
4808,48,8,270,170,62.96,100,37.04
4809,48,9,346,212,61.27,134,38.73
4810,48,10,762,364,47.77,398,52.23
4811,48,11,444,223,50.23,221,49.77
4812,48,12,648,287,44.29,361,55.71
4813,48,13,658,436,66.26,222,33.74
4814,48,14,233,145,62.23,88,37.77
4815,48,15,347,202,58.21,145,41.79
4816,48,16,596,318,53.36,278,46.64
4817,48,17,460,285,61.96,175,38.04
4818,48,18,351,213,60.68,138,39.32
4819,48,19,378,196,51.85,182,48.15
4820,48,20,583,279,47.86,304,52.14
4821,48,21,677,366,54.06,311,45.94
4822,48,22,406,274,67.49,132,32.51
4823,48,23,501,324,64.67,177,35.33
4824,48,24,626,337,53.83,289,46.17
4825,48,25,462,228,49.35,234,50.65
4826,48,26,254,151,59.45,103,40.55
4827,48,27,535,269,50.28,266,49.72
4828,48,28,586,359,61.26,227,38.74
4829,48,29,205,152,74.15,53,25.85
4830,48,30,469,231,49.25,238,50.75
4831,48,31,777,405,52.12,372,47.88
4832,48,32,571,339,59.37,232,40.63
4833,48,33,278,193,69.42,85,30.58
4834,48,34,468,236,50.43,232,49.57
4835,48,35,320,194,60.63,126,39.38
4836,48,36,295,194,65.76,101,34.24
4837,48,37,577,286,49.57,291,50.43
4838,48,38,564,342,60.64,222,39.36
4839,48,39,407,263,64.62,144,35.38
4840,48,40,486,261,53.7,225,46.3
4841,48,41,697,339,48.64,358,51.36
4842,48,42,623,280,44.94,343,55.06
4843,48,43,623,346,55.54,277,44.46
4844,48,44,685,342,49.93,343,50.07
4845,48,45,406,187,46.06,219,53.94
4846,48,46,317,182,57.41,135,42.59
4901,49,1,354,189,53.39,165,46.61
4902,49,2,343,175,51.02,168,48.98
4903,49,3,672,351,52.23,321,47.77
4904,49,4,734,346,47.14,388,52.86
4905,49,5,524,296,56.49,228,43.51
4906,49,6,476,274,57.56,202,42.44
4907,49,7,446,256,57.4,190,42.6
4908,49,8,488,303,62.09,185,37.91
4909,49,9,551,302,54.81,249,45.19
4910,49,10,631,349,55.31,282,44.69
4911,49,11,714,365,51.12,349,48.88
4912,49,12,678,351,51.77,327,48.23
4913,49,13,619,327,52.83,292,47.17
4914,49,14,423,222,52.48,201,47.52
4915,49,15,395,239,60.51,156,39.49
4916,49,16,508,286,56.3,222,43.7
4917,49,17,426,269,63.15,157,36.85
4918,49,18,707,342,48.37,365,51.63
4919,49,19,508,271,53.35,237,46.65
4920,49,20,837,401,47.91,436,52.09
4921,49,21,340,217,63.82,123,36.18
4922,49,22,570,319,55.96,251,44.04
4923,49,23,722,351,48.61,371,51.39
4924,49,24,424,249,58.73,175,41.27
4925,49,25,684,363,53.07,321,46.93
4926,49,26,633,316,49.92,317,50.08
4927,49,27,649,308,47.46,341,52.54
4928,49,28,794,368,46.35,426,53.65
4929,49,29,644,295,45.81,349,54.19
4930,49,30,575,313,54.43,262,45.57
4931,49,31,392,222,56.63,170,43.37
4932,49,32,525,256,48.76,269,51.24
4933,49,33,422,239,56.64,183,43.36
5001,50,1,357,248,69.47,109,30.53
5002,50,2,250,175,70.0,75,30.0
5003,50,3,321,213,66.36,108,33.64
5004,50,4,447,304,68.01,143,31.99
5005,50,5,243,174,71.6,69,28.4
5006,50,6,418,274,65.55,144,34.45
5007,50,7,511,313,61.25,198,38.75
5008,50,8,403,236,58.56,167,41.44
5009,50,9,334,208,62.28,126,37.72
5010,50,10,407,280,68.8,127,31.2
5011,50,11,217,156,71.89,61,28.11
5012,50,12,160,106,66.25,54,33.75
5013,50,13,503,319,63.42,184,36.58
5014,50,14,128,80,62.5,48,37.5
5015,50,15,512,312,60.94,200,39.06
5016,50,16,122,80,65.57,42,34.43
5017,50,17,408,285,69.85,123,30.15
5018,50,18,51,33,64.71,18,35.29
5019,50,19,343,236,68.8,107,31.2
5020,50,20,461,276,59.87,185,40.13
5021,50,21,377,241,63.93,136,36.07
5022,50,22,351,233,66.38,118,33.62
5023,50,23,280,175,62.5,105,37.5
5024,50,24,252,163,64.68,89,35.32
5025,50,25,335,202,60.3,133,39.7
5026,50,26,443,287,64.79,156,35.21
5027,50,27,111,70,63.06,41,36.94
5028,50,28,462,304,65.8,158,34.2
5029,50,29,423,277,65.48,146,34.52
5030,50,30,341,227,66.57,114,33.43
5031,50,31,591,378,63.96,213,36.04
5032,50,32,463,302,65.23,161,34.77
5033,50,33,260,182,70.0,78,30.0
5034,50,34,518,301,58.11,217,41.89
5035,50,35,557,334,59.96,223,40.04
5036,50,36,414,263,63.53,151,36.47
5037,50,37,427,269,63.0,158,37.0
5038,50,38,132,86,65.15,46,34.85
5039,50,39,251,164,65.34,87,34.66
5040,50,40,291,196,67.35,95,32.65
