id,ward,precinct,total,Yes,Yes Percent,No,No Percent
0101,1,1,505,377,74.65,128,25.35
0102,1,2,466,330,70.82,136,29.18
0103,1,3,606,509,83.99,97,16.01
0104,1,4,575,474,82.43,101,17.57
0105,1,5,516,420,81.4,96,18.6
0106,1,6,438,344,78.54,94,21.46
0107,1,7,367,295,80.38,72,19.62
0108,1,8,427,347,81.26,80,18.74
0109,1,9,357,287,80.39,70,19.61
0110,1,10,627,520,82.93,107,17.07
0111,1,11,572,492,86.01,80,13.99
0112,1,12,596,453,76.01,143,23.99
0113,1,13,251,197,78.49,54,21.51
0114,1,14,454,367,80.84,87,19.16
0115,1,15,464,365,78.66,99,21.34
0116,1,16,555,438,78.92,117,21.08
0117,1,17,428,320,74.77,108,25.23
0118,1,18,494,382,77.33,112,22.67
0119,1,19,601,471,78.37,130,21.63
0120,1,20,402,322,80.1,80,19.9
0121,1,21,676,557,82.4,119,17.6
0122,1,22,338,264,78.11,74,21.89
0123,1,23,652,518,79.45,134,20.55
0124,1,24,460,339,73.7,121,26.3
0125,1,25,495,373,75.35,122,24.65
0126,1,26,339,244,71.98,95,28.02
0127,1,27,574,472,82.23,102,17.77
0128,1,28,171,128,74.85,43,25.15
0129,1,29,626,507,80.99,119,19.01
0130,1,30,576,417,72.4,159,27.6
0131,1,31,453,360,79.47,93,20.53
0132,1,32,478,374,78.24,104,21.76
0133,1,33,539,439,81.45,100,18.55
0134,1,34,424,343,80.9,81,19.1
0135,1,35,634,486,76.66,148,23.34
0136,1,36,585,485,82.91,100,17.09
0137,1,37,497,411,82.7,86,17.3
0138,1,38,489,402,82.21,87,17.79
0139,1,39,427,354,82.9,73,17.1
0140,1,40,429,357,83.22,72,16.78
0141,1,41,287,239,83.28,48,16.72
0142,1,42,178,133,74.72,45,25.28
0143,1,43,327,263,80.43,64,19.57
0144,1,44,461,347,75.27,114,24.73
0201,2,1,555,450,81.08,105,18.92
0202,2,2,342,291,85.09,51,14.91
0203,2,3,572,468,81.82,104,18.18
0204,2,4,486,396,81.48,90,18.52
0205,2,5,616,483,78.41,133,21.59
0206,2,6,533,431,80.86,102,19.14
0207,2,7,440,363,82.5,77,17.5
0208,2,8,634,514,81.07,120,18.93
0209,2,9,457,393,86.0,64,14.0
0210,2,10,339,284,83.78,55,16.22
0211,2,11,457,384,84.03,73,15.97
0212,2,12,390,334,85.64,56,14.36
0213,2,13,384,332,86.46,52,13.54
0214,2,14,495,392,79.19,103,20.81
0215,2,15,435,356,81.84,79,18.16
0216,2,16,488,395,80.94,93,19.06
0217,2,17,576,456,79.17,120,20.83
0218,2,18,414,365,88.16,49,11.84
0219,2,19,297,237,79.8,60,20.2
0220,2,20,577,488,84.58,89,15.42
0221,2,21,515,424,82.33,91,17.67
0222,2,22,460,400,86.96,60,13.04
0223,2,23,292,253,86.64,39,13.36
0224,2,24,413,367,88.86,46,11.14
0225,2,25,539,452,83.86,87,16.14
0226,2,26,378,305,80.69,73,19.31
0227,2,27,402,324,80.6,78,19.4
0228,2,28,525,460,87.62,65,12.38
0229,2,29,508,416,81.89,92,18.11
0230,2,30,409,346,84.6,63,15.4
0231,2,31,526,451,85.74,75,14.26
0232,2,32,423,343,81.09,80,18.91
0233,2,33,636,540,84.91,96,15.09
0234,2,34,328,286,87.2,42,12.8
0235,2,35,606,519,85.64,87,14.36
0236,2,36,481,403,83.78,78,16.22
0237,2,37,403,343,85.11,60,14.89
0238,2,38,406,337,83.0,69,17.0
0239,2,39,319,243,76.18,76,23.82
0240,2,40,649,553,85.21,96,14.79
0241,2,41,549,457,83.24,92,16.76
0242,2,42,526,457,86.88,69,13.12
0243,2,43,618,519,83.98,99,16.02
0244,2,44,286,249,87.06,37,12.94
0245,2,45,544,460,84.56,84,15.44
0246,2,46,245,194,79.18,51,20.82
0301,3,1,631,462,73.22,169,26.78
0302,3,2,464,375,80.82,89,19.18
0303,3,3,377,278,73.74,99,26.26
0304,3,4,523,400,76.48,123,23.52
0305,3,5,262,191,72.9,71,27.1
0306,3,6,656,532,81.1,124,18.9
0307,3,7,253,185,73.12,68,26.88
0308,3,8,357,238,66.67,119,33.33
0309,3,9,533,373,69.98,160,30.02
0310,3,10,212,149,70.28,63,29.72
0311,3,11,532,380,71.43,152,28.57
0312,3,12,416,314,75.48,102,24.52
0313,3,13,543,454,83.61,89,16.39
0314,3,14,539,439,81.45,100,18.55
0315,3,15,446,312,69.96,134,30.04
0316,3,16,386,285,73.83,101,26.17
0317,3,17,681,526,77.24,155,22.76
0318,3,18,611,443,72.5,168,27.5
0319,3,19,570,477,83.68,93,16.32
0320,3,20,497,337,67.81,160,32.19
0321,3,21,492,410,83.33,82,16.67
0322,3,22,667,528,79.16,139,20.84
0323,3,23,381,271,71.13,110,28.87
0324,3,24,409,306,74.82,103,25.18
0325,3,25,790,658,83.29,132,16.71
0326,3,26,501,428,85.43,73,14.57
0327,3,27,603,487,80.76,116,19.24
0328,3,28,217,152,70.05,65,29.95
0329,3,29,478,324,67.78,154,32.22
0330,3,30,390,279,71.54,111,28.46
0331,3,31,537,392,73.0,145,27.0
0332,3,32,750,625,83.33,125,16.67
0333,3,33,594,492,82.83,102,17.17
0334,3,34,708,566,79.94,142,20.06
0335,3,35,246,179,72.76,67,27.24
0336,3,36,222,152,68.47,70,31.53
0337,3,37,444,303,68.24,141,31.76
0338,3,38,332,267,80.42,65,19.58
0339,3,39,943,785,83.24,158,16.76
0340,3,40,494,377,76.32,117,23.68
0341,3,41,317,227,71.61,90,28.39
0401,4,1,693,537,77.49,156,22.51
0402,4,2,651,547,84.02,104,15.98
0403,4,3,400,287,71.75,113,28.25
0404,4,4,641,448,69.89,193,30.11
0405,4,5,509,374,73.48,135,26.52
0406,4,6,520,411,79.04,109,20.96
0407,4,7,622,505,81.19,117,18.81
0408,4,8,530,379,71.51,151,28.49
0409,4,9,514,415,80.74,99,19.26
0410,4,10,610,462,75.74,148,24.26
0411,4,11,478,349,73.01,129,26.99
0412,4,12,651,487,74.81,164,25.19
0413,4,13,641,528,82.37,113,17.63
0414,4,14,482,364,75.52,118,24.48
0415,4,15,553,410,74.14,143,25.86
0416,4,16,854,731,85.6,123,14.4
0417,4,17,565,481,85.13,84,14.87
0418,4,18,468,346,73.93,122,26.07
0419,4,19,328,207,63.11,121,36.89
0420,4,20,371,311,83.83,60,16.17
0421,4,21,551,445,80.76,106,19.24
0422,4,22,433,350,80.83,83,19.17
0423,4,23,587,478,81.43,109,18.57
0424,4,24,456,353,77.41,103,22.59
0425,4,25,606,503,83.0,103,17.0
0426,4,26,430,320,74.42,110,25.58
0427,4,27,648,503,77.62,145,22.38
0428,4,28,436,323,74.08,113,25.92
0429,4,29,468,355,75.85,113,24.15
0430,4,30,676,477,70.56,199,29.44
0431,4,31,407,332,81.57,75,18.43
0432,4,32,547,409,74.77,138,25.23
0433,4,33,451,356,78.94,95,21.06
0434,4,34,440,332,75.45,108,24.55
0435,4,35,580,428,73.79,152,26.21
0436,4,36,586,456,77.82,130,22.18
0437,4,37,931,807,86.68,124,13.32
0438,4,38,545,427,78.35,118,21.65
0501,5,1,429,294,68.53,135,31.47
0502,5,2,347,236,68.01,111,31.99
0503,5,3,444,370,83.33,74,16.67
0504,5,4,596,455,76.34,141,23.66
0505,5,5,391,280,71.61,111,28.39
0506,5,6,339,237,69.91,102,30.09
0507,5,7,425,323,76.0,102,24.0
0508,5,8,429,388,90.44,41,9.56
0509,5,9,517,428,82.79,89,17.21
0510,5,10,376,259,68.88,117,31.12
0511,5,11,440,362,82.27,78,17.73
0512,5,12,286,203,70.98,83,29.02
0513,5,13,402,281,69.9,121,30.1
0514,5,14,357,272,76.19,85,23.81
0515,5,15,418,323,77.27,95,22.73
0516,5,16,437,285,65.22,152,34.78
0517,5,17,363,260,71.63,103,28.37
0518,5,18,411,315,76.64,96,23.36
0519,5,19,413,349,84.5,64,15.5
0520,5,20,470,393,83.62,77,16.38
0521,5,21,443,362,81.72,81,18.28
0522,5,22,513,421,82.07,92,17.93
0523,5,23,769,623,81.01,146,18.99
0524,5,24,567,447,78.84,120,21.16
0525,5,25,385,308,80.0,77,20.0
0526,5,26,450,317,70.44,133,29.56
0527,5,27,399,348,87.22,51,12.78
0528,5,28,456,343,75.22,113,24.78
0529,5,29,465,325,69.89,140,30.11
0530,5,30,293,183,62.46,110,37.54
0531,5,31,341,243,71.26,98,28.74
0532,5,32,492,363,73.78,129,26.22
0533,5,33,415,306,73.73,109,26.27
0534,5,34,435,372,85.52,63,14.48
0535,5,35,550,455,82.73,95,17.27
0536,5,36,257,200,77.82,57,22.18
0537,5,37,459,399,86.93,60,13.07
0538,5,38,418,279,66.75,139,33.25
0539,5,39,357,309,86.55,48,13.45
0540,5,40,353,240,67.99,113,32.01
0541,5,41,184,171,92.93,13,7.07
0601,6,1,368,277,75.27,91,24.73
0602,6,2,372,287,77.15,85,22.85
0603,6,3,357,283,79.27,74,20.73
0604,6,4,261,177,67.82,84,32.18
0605,6,5,233,153,65.67,80,34.33
0606,6,6,430,307,71.4,123,28.6
0607,6,7,370,250,67.57,120,32.43
0608,6,8,358,278,77.65,80,22.35
0609,6,9,387,266,68.73,121,31.27
0610,6,10,246,167,67.89,79,32.11
0611,6,11,317,229,72.24,88,27.76
0612,6,12,277,194,70.04,83,29.96
0613,6,13,271,192,70.85,79,29.15
0614,6,14,337,233,69.14,104,30.86
0615,6,15,317,204,64.35,113,35.65
0616,6,16,382,273,71.47,109,28.53
0617,6,17,237,163,68.78,74,31.22
0618,6,18,267,205,76.78,62,23.22
0619,6,19,296,197,66.55,99,33.45
0620,6,20,234,175,74.79,59,25.21
0621,6,21,176,110,62.5,66,37.5
0622,6,22,215,141,65.58,74,34.42
0623,6,23,162,111,68.52,51,31.48
0624,6,24,190,126,66.32,64,33.68
0625,6,25,187,123,65.78,64,34.22
0626,6,26,261,182,69.73,79,30.27
0627,6,27,219,153,69.86,66,30.14
0628,6,28,174,115,66.09,59,33.91
0629,6,29,354,260,73.45,94,26.55
0630,6,30,316,215,68.04,101,31.96
0631,6,31,315,257,81.59,58,18.41
0632,6,32,371,272,73.32,99,26.68
0633,6,33,365,267,73.15,98,26.85
0634,6,34,367,269,73.3,98,26.7
0635,6,35,335,237,70.75,98,29.25
0636,6,36,394,292,74.11,102,25.89
0637,6,37,398,296,74.37,102,25.63
0638,6,38,391,279,71.36,112,28.64
0639,6,39,297,211,71.04,86,28.96
0640,6,40,311,227,72.99,84,27.01
0641,6,41,365,240,65.75,125,34.25
0642,6,42,337,238,70.62,99,29.38
0643,6,43,327,228,69.72,99,30.28
0644,6,44,386,266,68.91,120,31.09
0645,6,45,370,261,70.54,109,29.46
0646,6,46,278,190,68.35,88,31.65
0647,6,47,248,178,71.77,70,28.23
0648,6,48,347,258,74.35,89,25.65
0701,7,1,350,249,71.14,101,28.86
0702,7,2,334,220,65.87,114,34.13
0703,7,3,340,247,72.65,93,27.35
0704,7,4,344,249,72.38,95,27.62
0705,7,5,309,218,70.55,91,29.45
0706,7,6,435,300,68.97,135,31.03
0707,7,7,346,235,67.92,111,32.08
0708,7,8,208,140,67.31,68,32.69
0709,7,9,594,417,70.2,177,29.8
0710,7,10,346,261,75.43,85,24.57
0711,7,11,381,260,68.24,121,31.76
0712,7,12,317,215,67.82,102,32.18
0713,7,13,194,143,73.71,51,26.29
0714,7,14,393,280,71.25,113,28.75
0715,7,15,325,240,73.85,85,26.15
0716,7,16,342,222,64.91,120,35.09
0717,7,17,285,193,67.72,92,32.28
0718,7,18,312,224,71.79,88,28.21
0719,7,19,334,244,73.05,90,26.95
0720,7,20,280,193,68.93,87,31.07
0721,7,21,265,174,65.66,91,34.34
0722,7,22,302,208,68.87,94,31.13
0723,7,23,315,229,72.7,86,27.3
0724,7,24,277,197,71.12,80,28.88
0725,7,25,286,199,69.58,87,30.42
0726,7,26,268,189,70.52,79,29.48
0727,7,27,258,187,72.48,71,27.52
0728,7,28,258,176,68.22,82,31.78
0729,7,29,322,223,69.25,99,30.75
0730,7,30,276,216,78.26,60,21.74
0731,7,31,251,167,66.53,84,33.47
0732,7,32,435,318,73.1,117,26.9
0733,7,33,411,308,74.94,103,25.06
0734,7,34,423,307,72.58,116,27.42
0735,7,35,381,272,71.39,109,28.61
0736,7,36,448,319,71.21,129,28.79
0737,7,37,344,254,73.84,90,26.16
0738,7,38,314,227,72.29,87,27.71
0739,7,39,319,225,70.53,94,29.47
0740,7,40,273,204,74.73,69,25.27
0741,7,41,334,255,76.35,79,23.65
0742,7,42,345,245,71.01,100,28.99
0743,7,43,331,249,75.23,82,24.77
0744,7,44,303,223,73.6,80,26.4
0745,7,45,327,236,72.17,91,27.83
0746,7,46,86,62,72.09,24,27.91
0801,8,1,321,226,70.4,95,29.6
0802,8,2,341,238,69.79,103,30.21
0803,8,3,381,287,75.33,94,24.67
0804,8,4,411,321,78.1,90,21.9
0805,8,5,301,242,80.4,59,19.6
0806,8,6,348,257,73.85,91,26.15
0807,8,7,404,298,73.76,106,26.24
0808,8,8,359,277,77.16,82,22.84
0809,8,9,232,169,72.84,63,27.16
0810,8,10,450,335,74.44,115,25.56
0811,8,11,303,208,68.65,95,31.35
0812,8,12,315,223,70.79,92,29.21
0813,8,13,415,296,71.33,119,28.67
0814,8,14,290,180,62.07,110,37.93
0815,8,15,226,181,80.09,45,19.91
0816,8,16,105,70,66.67,35,33.33
0817,8,17,293,223,76.11,70,23.89
0818,8,18,318,235,73.9,83,26.1
0819,8,19,391,307,78.52,84,21.48
0820,8,20,416,287,68.99,129,31.01
0821,8,21,460,319,69.35,141,30.65
0822,8,22,325,246,75.69,79,24.31
0823,8,23,279,207,74.19,72,25.81
0824,8,24,185,125,67.57,60,32.43
0825,8,25,352,239,67.9,113,32.1
0826,8,26,293,201,68.6,92,31.4
0827,8,27,390,277,71.03,113,28.97
0828,8,28,361,268,74.24,93,25.76
0829,8,29,373,276,73.99,97,26.01
0830,8,30,392,297,75.77,95,24.23
0831,8,31,278,196,70.5,82,29.5
0832,8,32,277,198,71.48,79,28.52
0833,8,33,264,183,69.32,81,30.68
0834,8,34,320,250,78.13,70,21.88
0835,8,35,401,289,72.07,112,27.93
0836,8,36,353,251,71.1,102,28.9
0837,8,37,270,194,71.85,76,28.15
0838,8,38,266,211,79.32,55,20.68
0839,8,39,332,238,71.69,94,28.31
0840,8,40,289,210,72.66,79,27.34
0841,8,41,375,263,70.13,112,29.87
0842,8,42,460,334,72.61,126,27.39
0843,8,43,199,134,67.34,65,32.66
0844,8,44,249,192,77.11,57,22.89
0845,8,45,305,212,69.51,93,30.49
0846,8,46,291,208,71.48,83,28.52
0847,8,47,292,213,72.95,79,27.05
0848,8,48,316,239,75.63,77,24.37
0849,8,49,343,238,69.39,105,30.61
0850,8,50,339,244,71.98,95,28.02
0851,8,51,336,255,75.89,81,24.11
0852,8,52,441,330,74.83,111,25.17
0853,8,53,207,152,73.43,55,26.57
0854,8,54,294,195,66.33,99,33.67
0855,8,55,260,202,77.69,58,22.31
0856,8,56,371,269,72.51,102,27.49
0901,9,1,319,234,73.35,85,26.65
0902,9,2,276,190,68.84,86,31.16
0903,9,3,213,138,64.79,75,35.21
0904,9,4,254,172,67.72,82,32.28
0905,9,5,332,240,72.29,92,27.71
0906,9,6,314,219,69.75,95,30.25
0907,9,7,263,187,71.1,76,28.9
0908,9,8,345,245,71.01,100,28.99
0909,9,9,374,263,70.32,111,29.68
0910,9,10,251,179,71.31,72,28.69
0911,9,11,246,176,71.54,70,28.46
0912,9,12,375,277,73.87,98,26.13
0913,9,13,377,282,74.8,95,25.2
0914,9,14,387,311,80.36,76,19.64
0915,9,15,344,209,60.76,135,39.24
0916,9,16,343,234,68.22,109,31.78
0917,9,17,221,170,76.92,51,23.08
0918,9,18,240,166,69.17,74,30.83
0919,9,19,348,251,72.13,97,27.87
0920,9,20,314,232,73.89,82,26.11
0921,9,21,308,215,69.81,93,30.19
0922,9,22,372,267,71.77,105,28.23
0923,9,23,366,260,71.04,106,28.96
0924,9,24,349,251,71.92,98,28.08
0925,9,25,288,206,71.53,82,28.47
0926,9,26,298,208,69.8,90,30.2
0927,9,27,272,201,73.9,71,26.1
0928,9,28,226,159,70.35,67,29.65
0929,9,29,294,194,65.99,100,34.01
0930,9,30,286,206,72.03,80,27.97
0931,9,31,283,204,72.08,79,27.92
0932,9,32,347,240,69.16,107,30.84
0933,9,33,244,177,72.54,67,27.46
0934,9,34,284,199,70.07,85,29.93
0935,9,35,312,235,75.32,77,24.68
0936,9,36,292,206,70.55,86,29.45
0937,9,37,504,345,68.45,159,31.55
0938,9,38,316,220,69.62,96,30.38
0939,9,39,353,252,71.39,101,28.61
0940,9,40,364,273,75.0,91,25.0
0941,9,41,275,188,68.36,87,31.64
0942,9,42,359,258,71.87,101,28.13
0943,9,43,296,199,67.23,97,32.77
0944,9,44,320,227,70.94,93,29.06
0945,9,45,251,175,69.72,76,30.28
0946,9,46,324,252,77.78,72,22.22
0947,9,47,350,265,75.71,85,24.29
0948,9,48,334,240,71.86,94,28.14
0949,9,49,356,260,73.03,96,26.97
0950,9,50,453,330,72.85,123,27.15
0951,9,51,328,249,75.91,79,24.09
1001,10,1,272,211,77.57,61,22.43
1002,10,2,334,227,67.96,107,32.04
1003,10,3,381,243,63.78,138,36.22
1004,10,4,274,188,68.61,86,31.39
1005,10,5,291,219,75.26,72,24.74
1006,10,6,289,217,75.09,72,24.91
1007,10,7,271,199,73.43,72,26.57
1008,10,8,186,123,66.13,63,33.87
1009,10,9,337,235,69.73,102,30.27
1010,10,10,400,280,70.0,120,30.0
1011,10,11,468,350,74.79,118,25.21
1012,10,12,260,181,69.62,79,30.38
1013,10,13,325,247,76.0,78,24.0
1014,10,14,459,349,76.03,110,23.97
1015,10,15,623,462,74.16,161,25.84
1016,10,16,305,213,69.84,92,30.16
1017,10,17,471,326,69.21,145,30.79
1018,10,18,206,146,70.87,60,29.13
1019,10,19,376,274,72.87,102,27.13
1020,10,20,366,266,72.68,100,27.32
1021,10,21,355,262,73.8,93,26.2
1022,10,22,218,169,77.52,49,22.48
1023,10,23,307,247,80.46,60,19.54
1024,10,24,335,240,71.64,95,28.36
1025,10,25,108,89,82.41,19,17.59
1026,10,26,256,198,77.34,58,22.66
1027,10,27,303,214,70.63,89,29.37
1028,10,28,401,304,75.81,97,24.19
1029,10,29,380,286,75.26,94,24.74
1030,10,30,326,240,73.62,86,26.38
1031,10,31,318,247,77.67,71,22.33
1032,10,32,378,274,72.49,104,27.51
1033,10,33,294,213,72.45,81,27.55
1034,10,34,243,163,67.08,80,32.92
1035,10,35,381,273,71.65,108,28.35
1036,10,36,87,70,80.46,17,19.54
1101,11,1,384,283,73.7,101,26.3
1102,11,2,34,20,58.82,14,41.18
1103,11,3,427,298,69.79,129,30.21
1104,11,4,291,223,76.63,68,23.37
1105,11,5,565,390,69.03,175,30.97
1106,11,6,669,533,79.67,136,20.33
1107,11,7,400,314,78.5,86,21.5
1108,11,8,392,286,72.96,106,27.04
1109,11,9,375,283,75.47,92,24.53
1110,11,10,393,305,77.61,88,22.39
1111,11,11,480,339,70.63,141,29.38
1112,11,12,526,398,75.67,128,24.33
1113,11,13,478,336,70.29,142,29.71
1114,11,14,198,150,75.76,48,24.24
1115,11,15,155,118,76.13,37,23.87
1116,11,16,290,233,80.34,57,19.66
1117,11,17,509,375,73.67,134,26.33
1118,11,18,324,244,75.31,80,24.69
1119,11,19,563,408,72.47,155,27.53
1120,11,20,282,205,72.7,77,27.3
1121,11,21,479,362,75.57,117,24.43
1122,11,22,531,382,71.94,149,28.06
1123,11,23,211,164,77.73,47,22.27
1124,11,24,468,360,76.92,108,23.08
1125,11,25,510,372,72.94,138,27.06
1126,11,26,431,317,73.55,114,26.45
1127,11,27,165,124,75.15,41,24.85
1128,11,28,200,152,76.0,48,24.0
1129,11,29,494,373,75.51,121,24.49
1130,11,30,212,157,74.06,55,25.94
1131,11,31,361,262,72.58,99,27.42
1132,11,32,167,122,73.05,45,26.95
1133,11,33,533,439,82.36,94,17.64
1134,11,34,115,76,66.09,39,33.91
1135,11,35,64,48,75.0,16,25.0
1136,11,36,180,140,77.78,40,22.22
1137,11,37,118,89,75.42,29,24.58
1138,11,38,218,153,70.18,65,29.82
1201,12,1,358,247,68.99,111,31.01
1202,12,2,304,232,76.32,72,23.68
1203,12,3,453,316,69.76,137,30.24
1204,12,4,446,333,74.66,113,25.34
1205,12,5,316,232,73.42,84,26.58
1206,12,6,426,318,74.65,108,25.35
1207,12,7,360,256,71.11,104,28.89
1208,12,8,372,271,72.85,101,27.15
1209,12,9,313,232,74.12,81,25.88
1210,12,10,510,352,69.02,158,30.98
1211,12,11,405,290,71.6,115,28.4
1212,12,12,369,268,72.63,101,27.37
1213,12,13,409,309,75.55,100,24.45
1214,12,14,331,235,71.0,96,29.0
1215,12,15,339,239,70.5,100,29.5
1216,12,16,330,224,67.88,106,32.12
1217,12,17,450,338,75.11,112,24.89
1218,12,18,358,249,69.55,109,30.45
1219,12,19,358,261,72.91,97,27.09
1220,12,20,474,353,74.47,121,25.53
1221,12,21,408,305,74.75,103,25.25
1222,12,22,376,241,64.1,135,35.9
1223,12,23,392,275,70.15,117,29.85
1301,13,1,309,208,67.31,101,32.69
1302,13,2,252,181,71.83,71,28.17
1303,13,3,288,206,71.53,82,28.47
1304,13,4,369,237,64.23,132,35.77
1305,13,5,420,305,72.62,115,27.38
1306,13,6,281,195,69.4,86,30.6
1307,13,7,296,212,71.62,84,28.38
1308,13,8,266,183,68.8,83,31.2
1309,13,9,392,302,77.04,90,22.96
1310,13,10,285,176,61.75,109,38.25
1311,13,11,348,232,66.67,116,33.33
1312,13,12,321,227,70.72,94,29.28
1313,13,13,337,260,77.15,77,22.85
1314,13,14,333,253,75.98,80,24.02
1315,13,15,486,348,71.6,138,28.4
1316,13,16,259,200,77.22,59,22.78
1317,13,17,308,226,73.38,82,26.62
1318,13,18,282,195,69.15,87,30.85
1319,13,19,445,349,78.43,96,21.57
1320,13,20,234,154,65.81,80,34.19
1321,13,21,366,245,66.94,121,33.06
1322,13,22,352,256,72.73,96,27.27
1323,13,23,292,209,71.58,83,28.42
1324,13,24,355,255,71.83,100,28.17
1325,13,25,350,249,71.14,101,28.86
1326,13,26,346,248,71.68,98,28.32
1327,13,27,312,222,71.15,90,28.85
1328,13,28,265,200,75.47,65,24.53
1329,13,29,298,222,74.5,76,25.5
1330,13,30,274,214,78.1,60,21.9
1331,13,31,359,233,64.9,126,35.1
1332,13,32,293,191,65.19,102,34.81
1333,13,33,332,244,73.49,88,26.51
1334,13,34,343,272,79.3,71,20.7
1335,13,35,296,233,78.72,63,21.28
1336,13,36,260,188,72.31,72,27.69
1337,13,37,333,260,78.08,73,21.92
1338,13,38,281,191,67.97,90,32.03
1339,13,39,332,262,78.92,70,21.08
1340,13,40,318,243,76.42,75,23.58
1341,13,41,432,324,75.0,108,25.0
1342,13,42,328,217,66.16,111,33.84
1343,13,43,328,229,69.82,99,30.18
1344,13,44,361,259,71.75,102,28.25
1345,13,45,367,272,74.11,95,25.89
1346,13,46,406,300,73.89,106,26.11
1347,13,47,373,293,78.55,80,21.45
1348,13,48,272,189,69.49,83,30.51
1401,14,1,362,247,68.23,115,31.77
1402,14,2,531,410,77.21,121,22.79
1403,14,3,368,268,72.83,100,27.17
1404,14,4,357,241,67.51,116,32.49
1405,14,5,541,383,70.79,158,29.21
1406,14,6,210,156,74.29,54,25.71
1407,14,7,507,373,73.57,134,26.43
1408,14,8,473,346,73.15,127,26.85
1409,14,9,460,301,65.43,159,34.57
1410,14,10,283,201,71.02,82,28.98
1411,14,11,229,166,72.49,63,27.51
1412,14,12,397,287,72.29,110,27.71
1413,14,13,359,262,72.98,97,27.02
1414,14,14,366,283,77.32,83,22.68
1415,14,15,380,291,76.58,89,23.42
1416,14,16,272,207,76.1,65,23.9
1417,14,17,337,232,68.84,105,31.16
1418,14,18,184,140,76.09,44,23.91
1419,14,19,363,286,78.79,77,21.21
1420,14,20,311,243,78.14,68,21.86
1421,14,21,378,285,75.4,93,24.6
1422,14,22,494,350,70.85,144,29.15
1423,14,23,267,183,68.54,84,31.46
1424,14,24,415,296,71.33,119,28.67
1425,14,25,192,134,69.79,58,30.21
1426,14,26,286,217,75.87,69,24.13
1427,14,27,355,261,73.52,94,26.48
1428,14,28,334,250,74.85,84,25.15
1429,14,29,284,209,73.59,75,26.41
1430,14,30,266,199,74.81,67,25.19
1431,14,31,213,169,79.34,44,20.66
1501,15,1,327,232,70.95,95,29.05
1502,15,2,200,131,65.5,69,34.5
1503,15,3,207,148,71.5,59,28.5
1504,15,4,369,283,76.69,86,23.31
1505,15,5,340,228,67.06,112,32.94
1506,15,6,375,278,74.13,97,25.87
1507,15,7,186,123,66.13,63,33.87
1508,15,8,370,253,68.38,117,31.62
1509,15,9,476,357,75.0,119,25.0
1510,15,10,498,369,74.1,129,25.9
1511,15,11,436,322,73.85,114,26.15
1512,15,12,457,349,76.37,108,23.63
1513,15,13,371,267,71.97,104,28.03
1514,15,14,332,232,69.88,100,30.12
1515,15,15,323,224,69.35,99,30.65
1516,15,16,417,316,75.78,101,24.22
1517,15,17,193,128,66.32,65,33.68
1518,15,18,141,89,63.12,52,36.88
1519,15,19,291,226,77.66,65,22.34
1520,15,20,211,145,68.72,66,31.28
1521,15,21,162,108,66.67,54,33.33
1522,15,22,192,122,63.54,70,36.46
1523,15,23,215,158,73.49,57,26.51
1524,15,24,184,116,63.04,68,36.96
1601,16,1,439,335,76.31,104,23.69
1602,16,2,254,158,62.2,96,37.8
1603,16,3,225,161,71.56,64,28.44
1604,16,4,300,195,65.0,105,35.0
1605,16,5,200,141,70.5,59,29.5
1606,16,6,233,158,67.81,75,32.19
1607,16,7,270,198,73.33,72,26.67
1608,16,8,193,141,73.06,52,26.94
1609,16,9,264,179,67.8,85,32.2
1610,16,10,220,155,70.45,65,29.55
1611,16,11,292,182,62.33,110,37.67
1612,16,12,258,186,72.09,72,27.91
1613,16,13,333,241,72.37,92,27.63
1614,16,14,202,138,68.32,64,31.68
1615,16,15,260,170,65.38,90,34.62
1616,16,16,207,151,72.95,56,27.05
1617,16,17,380,282,74.21,98,25.79
1618,16,18,318,228,71.7,90,28.3
1619,16,19,269,191,71.0,78,29.0
1620,16,20,167,120,71.86,47,28.14
1621,16,21,233,165,70.82,68,29.18
1622,16,22,222,158,71.17,64,28.83
1623,16,23,376,274,72.87,102,27.13
1624,16,24,128,91,71.09,37,28.91
1625,16,25,301,208,69.1,93,30.9
1626,16,26,175,120,68.57,55,31.43
1627,16,27,182,122,67.03,60,32.97
1628,16,28,198,144,72.73,54,27.27
1629,16,29,203,140,68.97,63,31.03
1630,16,30,190,138,72.63,52,27.37
1631,16,31,236,170,72.03,66,27.97
1632,16,32,378,271,71.69,107,28.31
1633,16,33,190,130,68.42,60,31.58
1634,16,34,222,167,75.23,55,24.77
1635,16,35,419,299,71.36,120,28.64
1636,16,36,173,120,69.36,53,30.64
1701,17,1,368,266,72.28,102,27.72
1702,17,2,292,203,69.52,89,30.48
1703,17,3,302,209,69.21,93,30.79
1704,17,4,328,221,67.38,107,32.62
1705,17,5,239,161,67.36,78,32.64
1706,17,6,331,240,72.51,91,27.49
1707,17,7,348,235,67.53,113,32.47
1708,17,8,218,148,67.89,70,32.11
1709,17,9,252,186,73.81,66,26.19
1710,17,10,393,291,74.05,102,25.95
1711,17,11,236,178,75.42,58,24.58
1712,17,12,486,346,71.19,140,28.81
1713,17,13,225,170,75.56,55,24.44
1714,17,14,371,292,78.71,79,21.29
1715,17,15,326,223,68.4,103,31.6
1716,17,16,397,284,71.54,113,28.46
1717,17,17,332,225,67.77,107,32.23
1718,17,18,367,271,73.84,96,26.16
1719,17,19,185,122,65.95,63,34.05
1720,17,20,399,313,78.45,86,21.55
1721,17,21,364,266,73.08,98,26.92
1722,17,22,304,220,72.37,84,27.63
1723,17,23,209,151,72.25,58,27.75
1724,17,24,255,193,75.69,62,24.31
1725,17,25,258,179,69.38,79,30.62
1726,17,26,315,242,76.83,73,23.17
1727,17,27,190,145,76.32,45,23.68
1728,17,28,230,171,74.35,59,25.65
1729,17,29,290,212,73.1,78,26.9
1730,17,30,327,232,70.95,95,29.05
1731,17,31,202,153,75.74,49,24.26
1732,17,32,244,176,72.13,68,27.87
1733,17,33,189,134,70.9,55,29.1
1734,17,34,233,181,77.68,52,22.32
1735,17,35,217,161,74.19,56,25.81
1736,17,36,232,166,71.55,66,28.45
1737,17,37,247,182,73.68,65,26.32
1738,17,38,348,263,75.57,85,24.43
1739,17,39,284,216,76.06,68,23.94
1740,17,40,353,255,72.24,98,27.76
1741,17,41,422,306,72.51,116,27.49
1801,18,1,361,248,68.7,113,31.3
1802,18,2,440,321,72.95,119,27.05
1803,18,3,316,231,73.1,85,26.9
1804,18,4,377,283,75.07,94,24.93
1805,18,5,222,151,68.02,71,31.98
1806,18,6,341,250,73.31,91,26.69
1807,18,7,373,268,71.85,105,28.15
1808,18,8,371,258,69.54,113,30.46
1809,18,9,348,259,74.43,89,25.57
1810,18,10,462,343,74.24,119,25.76
1811,18,11,349,247,70.77,102,29.23
1812,18,12,351,260,74.07,91,25.93
1813,18,13,392,294,75.0,98,25.0
1814,18,14,378,287,75.93,91,24.07
1815,18,15,404,283,70.05,121,29.95
1816,18,16,353,260,73.65,93,26.35
1817,18,17,398,292,73.37,106,26.63
1818,18,18,273,202,73.99,71,26.01
1819,18,19,308,222,72.08,86,27.92
1820,18,20,251,186,74.1,65,25.9
1821,18,21,457,332,72.65,125,27.35
1822,18,22,377,283,75.07,94,24.93
1823,18,23,364,262,71.98,102,28.02
1824,18,24,351,252,71.79,99,28.21
1825,18,25,397,302,76.07,95,23.93
1826,18,26,454,337,74.23,117,25.77
1827,18,27,325,224,68.92,101,31.08
1828,18,28,333,246,73.87,87,26.13
1829,18,29,440,322,73.18,118,26.82
1830,18,30,456,317,69.52,139,30.48
1831,18,31,396,275,69.44,121,30.56
1832,18,32,358,270,75.42,88,24.58
1833,18,33,272,204,75.0,68,25.0
1834,18,34,396,299,75.51,97,24.49
1835,18,35,421,311,73.87,110,26.13
1836,18,36,398,297,74.62,101,25.38
1837,18,37,419,307,73.27,112,26.73
1838,18,38,329,230,69.91,99,30.09
1839,18,39,306,217,70.92,89,29.08
1840,18,40,392,299,76.28,93,23.72
1841,18,41,446,322,72.2,124,27.8
1842,18,42,328,217,66.16,111,33.84
1843,18,43,329,247,75.08,82,24.92
1844,18,44,334,238,71.26,96,28.74
1845,18,45,387,293,75.71,94,24.29
1846,18,46,441,302,68.48,139,31.52
1847,18,47,289,205,70.93,84,29.07
1848,18,48,284,193,67.96,91,32.04
1849,18,49,237,157,66.24,80,33.76
1850,18,50,258,189,73.26,69,26.74
1901,19,1,339,228,67.26,111,32.74
1902,19,2,508,381,75.0,127,25.0
1903,19,3,307,185,60.26,122,39.74
1904,19,4,447,284,63.53,163,36.47
1905,19,5,429,333,77.62,96,22.38
1906,19,6,425,263,61.88,162,38.12
1907,19,7,333,232,69.67,101,30.33
1908,19,8,422,263,62.32,159,37.68
1909,19,9,269,193,71.75,76,28.25
1910,19,10,501,393,78.44,108,21.56
1911,19,11,364,204,56.04,160,43.96
1912,19,12,309,191,61.81,118,38.19
1913,19,13,475,338,71.16,137,28.84
1914,19,14,413,317,76.76,96,23.24
1915,19,15,523,328,62.72,195,37.28
1916,19,16,379,224,59.1,155,40.9
1917,19,17,351,250,71.23,101,28.77
1918,19,18,389,336,86.38,53,13.62
1919,19,19,485,384,79.18,101,20.82
1920,19,20,333,268,80.48,65,19.52
1921,19,21,410,249,60.73,161,39.27
1922,19,22,425,333,78.35,92,21.65
1923,19,23,390,292,74.87,98,25.13
1924,19,24,289,182,62.98,107,37.02
1925,19,25,380,296,77.89,84,22.11
1926,19,26,370,298,80.54,72,19.46
1927,19,27,411,298,72.51,113,27.49
1928,19,28,470,354,75.32,116,24.68
1929,19,29,399,236,59.15,163,40.85
1930,19,30,387,242,62.53,145,37.47
1931,19,31,355,291,81.97,64,18.03
1932,19,32,361,236,65.37,125,34.63
1933,19,33,429,284,66.2,145,33.8
1934,19,34,344,273,79.36,71,20.64
1935,19,35,361,292,80.89,69,19.11
1936,19,36,546,403,73.81,143,26.19
1937,19,37,405,320,79.01,85,20.99
1938,19,38,358,265,74.02,93,25.98
1939,19,39,201,141,70.15,60,29.85
1940,19,40,425,334,78.59,91,21.41
1941,19,41,366,226,61.75,140,38.25
1942,19,42,316,245,77.53,71,22.47
1943,19,43,537,400,74.49,137,25.51
1944,19,44,434,266,61.29,168,38.71
1945,19,45,425,292,68.71,133,31.29
1946,19,46,372,269,72.31,103,27.69
1947,19,47,581,423,72.81,158,27.19
1948,19,48,459,329,71.68,130,28.32
1949,19,49,485,373,76.91,112,23.09
1950,19,50,352,258,73.3,94,26.7
1951,19,51,437,320,73.23,117,26.77
1952,19,52,492,304,61.79,188,38.21
1953,19,53,362,268,74.03,94,25.97
1954,19,54,304,173,56.91,131,43.09
1955,19,55,329,205,62.31,124,37.69
1956,19,56,427,355,83.14,72,16.86
1957,19,57,341,272,79.77,69,20.23
2001,20,1,390,286,73.33,104,26.67
2002,20,2,123,80,65.04,43,34.96
2003,20,3,341,237,69.5,104,30.5
2004,20,4,159,106,66.67,53,33.33
2005,20,5,398,268,67.34,130,32.66
2006,20,6,155,104,67.1,51,32.9
2007,20,7,427,301,70.49,126,29.51
2008,20,8,312,231,74.04,81,25.96
2009,20,9,501,362,72.26,139,27.74
2010,20,10,240,162,67.5,78,32.5
2011,20,11,467,295,63.17,172,36.83
2012,20,12,352,231,65.63,121,34.38
2013,20,13,313,227,72.52,86,27.48
2014,20,14,187,140,74.87,47,25.13
2015,20,15,365,269,73.7,96,26.3
2016,20,16,431,308,71.46,123,28.54
2017,20,17,242,165,68.18,77,31.82
2018,20,18,240,156,65.0,84,35.0
2019,20,19,384,269,70.05,115,29.95
2020,20,20,281,208,74.02,73,25.98
2021,20,21,288,192,66.67,96,33.33
2022,20,22,489,357,73.01,132,26.99
2023,20,23,211,151,71.56,60,28.44
2024,20,24,446,332,74.44,114,25.56
2025,20,25,228,150,65.79,78,34.21
2026,20,26,336,250,74.4,86,25.6
2027,20,27,175,137,78.29,38,21.71
2028,20,28,224,158,70.54,66,29.46
2029,20,29,239,161,67.36,78,32.64
2030,20,30,162,130,80.25,32,19.75
2031,20,31,407,285,70.02,122,29.98
2032,20,32,273,172,63.0,101,37.0
2033,20,33,225,158,70.22,67,29.78
2034,20,34,438,339,77.4,99,22.6
2035,20,35,265,172,64.91,93,35.09
2036,20,36,118,91,77.12,27,22.88
2037,20,37,113,70,61.95,43,38.05
2038,20,38,100,68,68.0,32,32.0
2039,20,39,27,16,59.26,11,40.74
2101,21,1,390,288,73.85,102,26.15
2102,21,2,241,152,63.07,89,36.93
2103,21,3,347,249,71.76,98,28.24
2104,21,4,302,232,76.82,70,23.18
2105,21,5,364,255,70.05,109,29.95
2106,21,6,293,210,71.67,83,28.33
2107,21,7,336,257,76.49,79,23.51
2108,21,8,366,282,77.05,84,22.95
2109,21,9,364,273,75.0,91,25.0
2110,21,10,285,196,68.77,89,31.23
2111,21,11,311,238,76.53,73,23.47
2112,21,12,300,215,71.67,85,28.33
2113,21,13,374,271,72.46,103,27.54
2114,21,14,389,293,75.32,96,24.68
2115,21,15,328,248,75.61,80,24.39
2116,21,16,301,207,68.77,94,31.23
2117,21,17,288,214,74.31,74,25.69
2118,21,18,307,228,74.27,79,25.73
2119,21,19,404,288,71.29,116,28.71
2120,21,20,307,239,77.85,68,22.15
2121,21,21,314,225,71.66,89,28.34
2122,21,22,310,217,70.0,93,30.0
2123,21,23,322,240,74.53,82,25.47
2124,21,24,373,279,74.8,94,25.2
2125,21,25,302,204,67.55,98,32.45
2126,21,26,363,243,66.94,120,33.06
2127,21,27,403,285,70.72,118,29.28
2128,21,28,419,284,67.78,135,32.22
2129,21,29,379,267,70.45,112,29.55
2130,21,30,293,187,63.82,106,36.18
2131,21,31,197,155,78.68,42,21.32
2132,21,32,256,177,69.14,79,30.86
2133,21,33,291,212,72.85,79,27.15
2134,21,34,332,235,70.78,97,29.22
2135,21,35,409,301,73.59,108,26.41
2136,21,36,334,234,70.06,100,29.94
2137,21,37,242,176,72.73,66,27.27
2138,21,38,352,242,68.75,110,31.25
2139,21,39,342,233,68.13,109,31.87
2140,21,40,310,212,68.39,98,31.61
2141,21,41,369,267,72.36,102,27.64
2142,21,42,370,256,69.19,114,30.81
2143,21,43,346,242,69.94,104,30.06
2144,21,44,370,250,67.57,120,32.43
2145,21,45,325,228,70.15,97,29.85
2146,21,46,359,265,73.82,94,26.18
2147,21,47,324,216,66.67,108,33.33
2148,21,48,352,271,76.99,81,23.01
2149,21,49,385,281,72.99,104,27.01
2150,21,50,268,186,69.4,82,30.6
2151,21,51,366,264,72.13,102,27.87
2152,21,52,338,234,69.23,104,30.77
2153,21,53,302,213,70.53,89,29.47
2154,21,54,272,192,70.59,80,29.41
2201,22,1,194,132,68.04,62,31.96
2202,22,2,442,313,70.81,129,29.19
2203,22,3,548,386,70.44,162,29.56
2204,22,4,297,226,76.09,71,23.91
2205,22,5,334,235,70.36,99,29.64
2206,22,6,328,250,76.22,78,23.78
2207,22,7,290,226,77.93,64,22.07
2208,22,8,488,385,78.89,103,21.11
2209,22,9,291,214,73.54,77,26.46
2210,22,10,457,331,72.43,126,27.57
2211,22,11,244,163,66.8,81,33.2
2212,22,12,278,189,67.99,89,32.01
2213,22,13,369,271,73.44,98,26.56
2214,22,14,289,209,72.32,80,27.68
2215,22,15,310,211,68.06,99,31.94
2216,22,16,294,218,74.15,76,25.85
2217,22,17,476,332,69.75,144,30.25
2218,22,18,327,222,67.89,105,32.11
2219,22,19,171,119,69.59,52,30.41
2220,22,20,380,282,74.21,98,25.79
2221,22,21,320,224,70.0,96,30.0
2222,22,22,349,252,72.21,97,27.79
2223,22,23,353,268,75.92,85,24.08
2224,22,24,420,329,78.33,91,21.67
2225,22,25,344,265,77.03,79,22.97
2301,23,1,328,224,68.29,104,31.71
2302,23,2,364,239,65.66,125,34.34
2303,23,3,319,214,67.08,105,32.92
2304,23,4,319,229,71.79,90,28.21
2305,23,5,365,274,75.07,91,24.93
2306,23,6,348,256,73.56,92,26.44
2307,23,7,360,251,69.72,109,30.28
2308,23,8,434,297,68.43,137,31.57
2309,23,9,352,253,71.88,99,28.13
2310,23,10,412,301,73.06,111,26.94
2311,23,11,413,332,80.39,81,19.61
2312,23,12,366,245,66.94,121,33.06
2313,23,13,344,258,75.0,86,25.0
2314,23,14,298,188,63.09,110,36.91
2315,23,15,319,247,77.43,72,22.57
2316,23,16,334,222,66.47,112,33.53
2317,23,17,291,205,70.45,86,29.55
2318,23,18,321,220,68.54,101,31.46
2319,23,19,318,231,72.64,87,27.36
2320,23,20,260,204,78.46,56,21.54
2321,23,21,301,193,64.12,108,35.88
2322,23,22,332,244,73.49,88,26.51
2323,23,23,330,216,65.45,114,34.55
2324,23,24,323,237,73.37,86,26.63
2325,23,25,325,244,75.08,81,24.92
2326,23,26,358,270,75.42,88,24.58
2327,23,27,298,208,69.8,90,30.2
2328,23,28,389,261,67.1,128,32.9
2329,23,29,299,205,68.56,94,31.44
2330,23,30,449,324,72.16,125,27.84
2331,23,31,300,217,72.33,83,27.67
2332,23,32,355,246,69.3,109,30.7
2333,23,33,406,309,76.11,97,23.89
2334,23,34,392,279,71.17,113,28.83
2335,23,35,250,162,64.8,88,35.2
2336,23,36,340,237,69.71,103,30.29
2337,23,37,375,237,63.2,138,36.8
2338,23,38,323,231,71.52,92,28.48
2339,23,39,389,300,77.12,89,22.88
2401,24,1,234,170,72.65,64,27.35
2402,24,2,284,199,70.07,85,29.93
2403,24,3,349,239,68.48,110,31.52
2404,24,4,241,162,67.22,79,32.78
2405,24,5,161,120,74.53,41,25.47
2406,24,6,317,217,68.45,100,31.55
2407,24,7,228,169,74.12,59,25.88
2408,24,8,135,88,65.19,47,34.81
2409,24,9,270,183,67.78,87,32.22
2410,24,10,146,99,67.81,47,32.19
2411,24,11,292,200,68.49,92,31.51
2412,24,12,183,126,68.85,57,31.15
2413,24,13,183,116,63.39,67,36.61
2414,24,14,236,161,68.22,75,31.78
2415,24,15,156,119,76.28,37,23.72
2416,24,16,875,520,59.43,355,40.57
2417,24,17,204,135,66.18,69,33.82
2418,24,18,248,173,69.76,75,30.24
2419,24,19,316,215,68.04,101,31.96
2420,24,20,260,186,71.54,74,28.46
2421,24,21,156,103,66.03,53,33.97
2422,24,22,347,217,62.54,130,37.46
2423,24,23,259,182,70.27,77,29.73
2424,24,24,328,199,60.67,129,39.33
2425,24,25,197,143,72.59,54,27.41
2426,24,26,415,310,74.7,105,25.3
2427,24,27,306,228,74.51,78,25.49
2428,24,28,172,127,73.84,45,26.16
2429,24,29,206,145,70.39,61,29.61
2430,24,30,178,123,69.1,55,30.9
2431,24,31,299,197,65.89,102,34.11
2432,24,32,148,108,72.97,40,27.03
2433,24,33,178,126,70.79,52,29.21
2434,24,34,274,192,70.07,82,29.93
2435,24,35,260,168,64.62,92,35.38
2436,24,36,334,230,68.86,104,31.14
2437,24,37,138,96,69.57,42,30.43
2438,24,38,244,165,67.62,79,32.38
2439,24,39,276,189,68.48,87,31.52
2440,24,40,334,216,64.67,118,35.33
2441,24,41,132,93,70.45,39,29.55
2501,25,1,361,264,73.13,97,26.87
2502,25,2,541,391,72.27,150,27.73
2503,25,3,718,598,83.29,120,16.71
2504,25,4,343,262,76.38,81,23.62
2505,25,5,438,306,69.86,132,30.14
2506,25,6,141,111,78.72,30,21.28
2507,25,7,443,310,69.98,133,30.02
2508,25,8,522,362,69.35,160,30.65
2509,25,9,443,319,72.01,124,27.99
2510,25,10,585,503,85.98,82,14.02
2511,25,11,503,360,71.57,143,28.43
2512,25,12,442,315,71.27,127,28.73
2513,25,13,517,378,73.11,139,26.89
2514,25,14,284,235,82.75,49,17.25
2515,25,15,388,258,66.49,130,33.51
2516,25,16,709,607,85.61,102,14.39
2517,25,17,447,329,73.6,118,26.4
2518,25,18,223,179,80.27,44,19.73
2519,25,19,459,317,69.06,142,30.94
2520,25,20,247,155,62.75,92,37.25
2521,25,21,846,731,86.41,115,13.59
2522,25,22,464,322,69.4,142,30.6
2523,25,23,512,372,72.66,140,27.34
2524,25,24,468,341,72.86,127,27.14
2525,25,25,381,296,77.69,85,22.31
2526,25,26,465,330,70.97,135,29.03
2527,25,27,565,457,80.88,108,19.12
2528,25,28,478,340,71.13,138,28.87
2529,25,29,330,240,72.73,90,27.27
2530,25,30,443,289,65.24,154,34.76
2531,25,31,807,691,85.63,116,14.37
2532,25,32,359,252,70.19,107,29.81
2601,26,1,369,283,76.69,86,23.31
2602,26,2,271,189,69.74,82,30.26
2603,26,3,420,333,79.29,87,20.71
2604,26,4,248,168,67.74,80,32.26
2605,26,5,316,208,65.82,108,34.18
2606,26,6,299,224,74.92,75,25.08
2607,26,7,337,259,76.85,78,23.15
2608,26,8,215,145,67.44,70,32.56
2609,26,9,286,205,71.68,81,28.32
2610,26,10,350,248,70.86,102,29.14
2611,26,11,322,226,70.19,96,29.81
2612,26,12,341,242,70.97,99,29.03
2613,26,13,188,137,72.87,51,27.13
2614,26,14,277,190,68.59,87,31.41
2615,26,15,217,155,71.43,62,28.57
2616,26,16,188,137,72.87,51,27.13
2617,26,17,311,252,81.03,59,18.97
2618,26,18,250,187,74.8,63,25.2
2619,26,19,208,138,66.35,70,33.65
2620,26,20,291,209,71.82,82,28.18
2621,26,21,423,293,69.27,130,30.73
2622,26,22,188,140,74.47,48,25.53
2623,26,23,247,176,71.26,71,28.74
2624,26,24,275,192,69.82,83,30.18
2625,26,25,250,180,72.0,70,28.0
2626,26,26,253,174,68.77,79,31.23
2627,26,27,370,258,69.73,112,30.27
2628,26,28,446,353,79.15,93,20.85
2629,26,29,176,121,68.75,55,31.25
2630,26,30,272,188,69.12,84,30.88
2631,26,31,156,99,63.46,57,36.54
2632,26,32,402,311,77.36,91,22.64
2633,26,33,367,276,75.2,91,24.8
2634,26,34,355,268,75.49,87,24.51
2635,26,35,277,187,67.51,90,32.49
2636,26,36,330,235,71.21,95,28.79
2637,26,37,353,275,77.9,78,22.1
2638,26,38,172,123,71.51,49,28.49
2639,26,39,389,293,75.32,96,24.68
2640,26,40,199,127,63.82,72,36.18
2641,26,41,392,301,76.79,91,23.21
2642,26,42,273,192,70.33,81,29.67
2643,26,43,220,161,73.18,59,26.82
2644,26,44,178,127,71.35,51,28.65
2645,26,45,174,122,70.11,52,29.89
2646,26,46,247,178,72.06,69,27.94
2647,26,47,242,178,73.55,64,26.45
2648,26,48,355,264,74.37,91,25.63
2649,26,49,210,162,77.14,48,22.86
2701,27,1,889,740,83.24,149,16.76
2702,27,2,407,326,80.1,81,19.9
2703,27,3,176,119,67.61,57,32.39
2704,27,4,202,133,65.84,69,34.16
2705,27,5,298,202,67.79,96,32.21
2706,27,6,454,354,77.97,100,22.03
2707,27,7,571,457,80.04,114,19.96
2708,27,8,323,235,72.76,88,27.24
2709,27,9,182,150,82.42,32,17.58
2710,27,10,264,205,77.65,59,22.35
2711,27,11,458,386,84.28,72,15.72
2712,27,12,300,267,89.0,33,11.0
2713,27,13,529,413,78.07,116,21.93
2714,27,14,193,136,70.47,57,29.53
2715,27,15,182,110,60.44,72,39.56
2716,27,16,456,379,83.11,77,16.89
2717,27,17,401,293,73.07,108,26.93
2718,27,18,245,162,66.12,83,33.88
2719,27,19,177,125,70.62,52,29.38
2720,27,20,271,181,66.79,90,33.21
2721,27,21,361,309,85.6,52,14.4
2722,27,22,161,107,66.46,54,33.54
2723,27,23,218,161,73.85,57,26.15
2724,27,24,256,179,69.92,77,30.08
2725,27,25,352,254,72.16,98,27.84
2726,27,26,247,179,72.47,68,27.53
2727,27,27,499,374,74.95,125,25.05
2728,27,28,515,430,83.5,85,16.5
2729,27,29,248,166,66.94,82,33.06
2730,27,30,166,112,67.47,54,32.53
2731,27,31,275,183,66.55,92,33.45
2732,27,32,345,253,73.33,92,26.67
2733,27,33,548,443,80.84,105,19.16
2734,27,34,194,140,72.16,54,27.84
2735,27,35,515,417,80.97,98,19.03
2736,27,36,268,198,73.88,70,26.12
2737,27,37,347,279,80.4,68,19.6
2738,27,38,511,417,81.6,94,18.4
2739,27,39,261,172,65.9,89,34.1
2740,27,40,540,420,77.78,120,22.22
2741,27,41,259,194,74.9,65,25.1
2742,27,42,250,205,82.0,45,18.0
2743,27,43,309,233,75.4,76,24.6
2744,27,44,265,173,65.28,92,34.72
2745,27,45,1101,912,82.83,189,17.17
2746,27,46,336,293,87.2,43,12.8
2747,27,47,228,191,83.77,37,16.23
2748,27,48,680,516,75.88,164,24.12
2749,27,49,268,194,72.39,74,27.61
2750,27,50,319,217,68.03,102,31.97
2801,28,1,206,141,68.45,65,31.55
2802,28,2,246,161,65.45,85,34.55
2803,28,3,217,145,66.82,72,33.18
2804,28,4,284,232,81.69,52,18.31
2805,28,5,176,138,78.41,38,21.59
2806,28,6,169,135,79.88,34,20.12
2807,28,7,278,203,73.02,75,26.98
2808,28,8,483,406,84.06,77,15.94
2809,28,9,285,205,71.93,80,28.07
2810,28,10,382,287,75.13,95,24.87
2811,28,11,702,509,72.51,193,27.49
2812,28,12,260,200,76.92,60,23.08
2813,28,13,280,204,72.86,76,27.14
2814,28,14,274,199,72.63,75,27.37
2815,28,15,52,41,78.85,11,21.15
2816,28,16,178,120,67.42,58,32.58
2817,28,17,245,175,71.43,70,28.57
2818,28,18,240,165,68.75,75,31.25
2819,28,19,282,205,72.7,77,27.3
2820,28,20,229,160,69.87,69,30.13
2821,28,21,248,176,70.97,72,29.03
2822,28,22,261,187,71.65,74,28.35
2823,28,23,330,243,73.64,87,26.36
2824,28,24,248,162,65.32,86,34.68
2825,28,25,434,309,71.2,125,28.8
2826,28,26,254,163,64.17,91,35.83
2827,28,27,319,253,79.31,66,20.69
2828,28,28,395,319,80.76,76,19.24
2829,28,29,152,101,66.45,51,33.55
2830,28,30,45,33,73.33,12,26.67
2831,28,31,303,220,72.61,83,27.39
2832,28,32,278,199,71.58,79,28.42
2833,28,33,304,217,71.38,87,28.62
2834,28,34,505,346,68.51,159,31.49
2835,28,35,301,218,72.43,83,27.57
2836,28,36,136,100,73.53,36,26.47
2837,28,37,314,221,70.38,93,29.62
2838,28,38,119,90,75.63,29,24.37
2839,28,39,216,146,67.59,70,32.41
2840,28,40,357,255,71.43,102,28.57
2841,28,41,188,129,68.62,59,31.38
2842,28,42,286,202,70.63,84,29.37
2843,28,43,329,234,71.12,95,28.88
2844,28,44,221,146,66.06,75,33.94
2845,28,45,463,377,81.43,86,18.57
2846,28,46,573,415,72.43,158,27.57
2901,29,1,526,414,78.71,112,21.29
2902,29,2,434,311,71.66,123,28.34
2903,29,3,315,230,73.02,85,26.98
2904,29,4,424,313,73.82,111,26.18
2905,29,5,262,180,68.7,82,31.3
2906,29,6,262,192,73.28,70,26.72
2907,29,7,389,283,72.75,106,27.25
2908,29,8,350,260,74.29,90,25.71
2909,29,9,417,323,77.46,94,22.54
2910,29,10,481,376,78.17,105,21.83
2911,29,11,195,142,72.82,53,27.18
2912,29,12,450,323,71.78,127,28.22
2913,29,13,338,231,68.34,107,31.66
2914,29,14,321,231,71.96,90,28.04
2915,29,15,415,312,75.18,103,24.82
2916,29,16,351,257,73.22,94,26.78
2917,29,17,353,278,78.75,75,21.25
2918,29,18,334,243,72.75,91,27.25
2919,29,19,350,257,73.43,93,26.57
2920,29,20,379,257,67.81,122,32.19
2921,29,21,454,308,67.84,146,32.16
2922,29,22,261,180,68.97,81,31.03
2923,29,23,447,324,72.48,123,27.52
2924,29,24,362,269,74.31,93,25.69
2925,29,25,423,313,74.0,110,26.0
2926,29,26,339,257,75.81,82,24.19
2927,29,27,335,243,72.54,92,27.46
2928,29,28,428,310,72.43,118,27.57
2929,29,29,441,310,70.29,131,29.71
2930,29,30,508,379,74.61,129,25.39
2931,29,31,396,279,70.45,117,29.55
2932,29,32,401,284,70.82,117,29.18
2933,29,33,249,190,76.31,59,23.69
2934,29,34,262,179,68.32,83,31.68
2935,29,35,278,187,67.27,91,32.73
2936,29,36,335,244,72.84,91,27.16
2937,29,37,347,241,69.45,106,30.55
2938,29,38,476,362,76.05,114,23.95
2939,29,39,405,298,73.58,107,26.42
2940,29,40,405,306,75.56,99,24.44
2941,29,41,305,211,69.18,94,30.82
2942,29,42,385,279,72.47,106,27.53
2943,29,43,464,360,77.59,104,22.41
2944,29,44,387,269,69.51,118,30.49
3001,30,1,458,348,75.98,110,24.02
3002,30,2,411,311,75.67,100,24.33
3003,30,3,353,275,77.9,78,22.1
3004,30,4,410,299,72.93,111,27.07
3005,30,5,328,242,73.78,86,26.22
3006,30,6,287,213,74.22,74,25.78
3007,30,7,456,315,69.08,141,30.92
3008,30,8,514,372,72.37,142,27.63
3009,30,9,353,268,75.92,85,24.08
3010,30,10,395,291,73.67,104,26.33
3011,30,11,422,312,73.93,110,26.07
3012,30,12,378,287,75.93,91,24.07
3013,30,13,423,314,74.23,109,25.77
3014,30,14,304,215,70.72,89,29.28
3015,30,15,371,308,83.02,63,16.98
3016,30,16,224,165,73.66,59,26.34
3017,30,17,424,328,77.36,96,22.64
3018,30,18,529,399,75.43,130,24.57
3019,30,19,446,320,71.75,126,28.25
3020,30,20,444,322,72.52,122,27.48
3021,30,21,295,220,74.58,75,25.42
3022,30,22,620,448,72.26,172,27.74
3023,30,23,535,392,73.27,143,26.73
3024,30,24,604,431,71.36,173,28.64
3025,30,25,623,451,72.39,172,27.61
3026,30,26,263,197,74.9,66,25.1
3027,30,27,301,227,75.42,74,24.58
3028,30,28,438,345,78.77,93,21.23
3029,30,29,294,210,71.43,84,28.57
3030,30,30,182,139,76.37,43,23.63
3031,30,31,262,194,74.05,68,25.95
3032,30,32,346,270,78.03,76,21.97
3101,31,1,274,193,70.44,81,29.56
3102,31,2,257,192,74.71,65,25.29
3103,31,3,265,197,74.34,68,25.66
3104,31,4,355,267,75.21,88,24.79
3105,31,5,308,245,79.55,63,20.45
3106,31,6,196,154,78.57,42,21.43
3107,31,7,409,318,77.75,91,22.25
3108,31,8,269,196,72.86,73,27.14
3109,31,9,313,238,76.04,75,23.96
3110,31,10,341,267,78.3,74,21.7
3111,31,11,214,153,71.5,61,28.5
3112,31,12,235,176,74.89,59,25.11
3113,31,13,313,227,72.52,86,27.48
3114,31,14,276,216,78.26,60,21.74
3115,31,15,287,211,73.52,76,26.48
3116,31,16,345,246,71.3,99,28.7
3117,31,17,262,206,78.63,56,21.37
3118,31,18,264,206,78.03,58,21.97
3119,31,19,256,181,70.7,75,29.3
3120,31,20,244,170,69.67,74,30.33
3121,31,21,256,197,76.95,59,23.05
3122,31,22,244,175,71.72,69,28.28
3123,31,23,314,236,75.16,78,24.84
3124,31,24,285,217,76.14,68,23.86
3125,31,25,296,220,74.32,76,25.68
3126,31,26,286,220,76.92,66,23.08
3127,31,27,301,217,72.09,84,27.91
3128,31,28,275,198,72.0,77,28.0
3129,31,29,274,206,75.18,68,24.82
3130,31,30,240,182,75.83,58,24.17
3131,31,31,237,173,73.0,64,27.0
3132,31,32,229,169,73.8,60,26.2
3133,31,33,265,204,76.98,61,23.02
3134,31,34,286,215,75.17,71,24.83
3135,31,35,349,267,76.5,82,23.5
3136,31,36,279,209,74.91,70,25.09
3137,31,37,272,199,73.16,73,26.84
3138,31,38,255,193,75.69,62,24.31
3139,31,39,311,235,75.56,76,24.44
3140,31,40,327,220,67.28,107,32.72
3141,31,41,271,205,75.65,66,24.35
3201,32,1,650,537,82.62,113,17.38
3202,32,2,573,469,81.85,104,18.15
3203,32,3,536,412,76.87,124,23.13
3204,32,4,450,386,85.78,64,14.22
3205,32,5,536,450,83.96,86,16.04
3206,32,6,611,530,86.74,81,13.26
3207,32,7,586,494,84.3,92,15.7
3208,32,8,626,545,87.06,81,12.94
3209,32,9,518,412,79.54,106,20.46
3210,32,10,582,459,78.87,123,21.13
3211,32,11,458,358,78.17,100,21.83
3212,32,12,341,262,76.83,79,23.17
3213,32,13,559,462,82.65,97,17.35
3214,32,14,549,439,79.96,110,20.04
3215,32,15,484,402,83.06,82,16.94
3216,32,16,482,385,79.88,97,20.12
3217,32,17,498,383,76.91,115,23.09
3218,32,18,500,423,84.6,77,15.4
3219,32,19,482,400,82.99,82,17.01
3220,32,20,489,381,77.91,108,22.09
3221,32,21,513,435,84.8,78,15.2
3222,32,22,640,529,82.66,111,17.34
3223,32,23,544,472,86.76,72,13.24
3224,32,24,434,365,84.1,69,15.9
3225,32,25,506,433,85.57,73,14.43
3226,32,26,531,426,80.23,105,19.77
3227,32,27,519,431,83.04,88,16.96
3228,32,28,531,412,77.59,119,22.41
3229,32,29,544,445,81.8,99,18.2
3230,32,30,499,435,87.17,64,12.83
3231,32,31,551,456,82.76,95,17.24
3232,32,32,604,525,86.92,79,13.08
3233,32,33,454,405,89.21,49,10.79
3234,32,34,566,479,84.63,87,15.37
3235,32,35,493,400,81.14,93,18.86
3236,32,36,529,452,85.44,77,14.56
3237,32,37,597,493,82.58,104,17.42
3238,32,38,490,416,84.9,74,15.1
3239,32,39,569,488,85.76,81,14.24
3240,32,40,528,456,86.36,72,13.64
3241,32,41,548,464,84.67,84,15.33
3242,32,42,480,399,83.13,81,16.88
3243,32,43,464,366,78.88,98,21.12
3301,33,1,558,437,78.32,121,21.68
3302,33,2,701,529,75.46,172,24.54
3303,33,3,752,588,78.19,164,21.81
3304,33,4,709,549,77.43,160,22.57
3305,33,5,514,415,80.74,99,19.26
3306,33,6,489,380,77.71,109,22.29
3307,33,7,565,418,73.98,147,26.02
3308,33,8,667,558,83.66,109,16.34
3309,33,9,602,486,80.73,116,19.27
3310,33,10,456,367,80.48,89,19.52
3311,33,11,550,437,79.45,113,20.55
3312,33,12,552,445,80.62,107,19.38
3313,33,13,533,396,74.3,137,25.7
3314,33,14,259,202,77.99,57,22.01
3315,33,15,559,446,79.79,113,20.21
3316,33,16,730,563,77.12,167,22.88
3317,33,17,560,421,75.18,139,24.82
3318,33,18,767,603,78.62,164,21.38
3319,33,19,638,502,78.68,136,21.32
3320,33,20,686,552,80.47,134,19.53
3321,33,21,600,447,74.5,153,25.5
3322,33,22,506,393,77.67,113,22.33
3323,33,23,609,463,76.03,146,23.97
3324,33,24,671,578,86.14,93,13.86
3325,33,25,654,524,80.12,130,19.88
3326,33,26,400,284,71.0,116,29.0
3327,33,27,634,478,75.39,156,24.61
3328,33,28,506,390,77.08,116,22.92
3401,34,1,405,292,72.1,113,27.9
3402,34,2,307,235,76.55,72,23.45
3403,34,3,357,249,69.75,108,30.25
3404,34,4,277,213,76.9,64,23.1
3405,34,5,308,225,73.05,83,26.95
3406,34,6,398,301,75.63,97,24.37
3407,34,7,380,290,76.32,90,23.68
3408,34,8,300,220,73.33,80,26.67
3409,34,9,241,168,69.71,73,30.29
3410,34,10,301,221,73.42,80,26.58
3411,34,11,321,224,69.78,97,30.22
3412,34,12,375,277,73.87,98,26.13
3413,34,13,365,268,73.42,97,26.58
3414,34,14,282,213,75.53,69,24.47
3415,34,15,328,236,71.95,92,28.05
3416,34,16,329,234,71.12,95,28.88
3417,34,17,447,346,77.4,101,22.6
3418,34,18,210,150,71.43,60,28.57
3419,34,19,383,294,76.76,89,23.24
3420,34,20,405,306,75.56,99,24.44
3421,34,21,421,315,74.82,106,25.18
3422,34,22,360,269,74.72,91,25.28
3423,34,23,304,224,73.68,80,26.32
3424,34,24,307,226,73.62,81,26.38
3425,34,25,533,402,75.42,131,24.58
3426,34,26,417,309,74.1,108,25.9
3427,34,27,287,208,72.47,79,27.53
3428,34,28,225,165,73.33,60,26.67
3429,34,29,285,194,68.07,91,31.93
3430,34,30,332,260,78.31,72,21.69
3431,34,31,283,211,74.56,72,25.44
3432,34,32,355,265,74.65,90,25.35
3433,34,33,297,213,71.72,84,28.28
3434,34,34,415,311,74.94,104,25.06
3435,34,35,446,318,71.3,128,28.7
3436,34,36,311,234,75.24,77,24.76
3437,34,37,208,139,66.83,69,33.17
3438,34,38,181,119,65.75,62,34.25
3439,34,39,263,168,63.88,95,36.12
3440,34,40,379,276,72.82,103,27.18
3441,34,41,215,147,68.37,68,31.63
3442,34,42,355,271,76.34,84,23.66
3443,34,43,331,265,80.06,66,19.94
3444,34,44,306,235,76.8,71,23.2
3445,34,45,355,260,73.24,95,26.76
3446,34,46,240,181,75.42,59,24.58
3447,34,47,317,248,78.23,69,21.77
3448,34,48,369,297,80.49,72,19.51
3449,34,49,323,268,82.97,55,17.03
3450,34,50,292,223,76.37,69,23.63
3451,34,51,414,296,71.5,118,28.5
3452,34,52,285,221,77.54,64,22.46
3453,34,53,242,174,71.9,68,28.1
3501,35,1,460,335,72.83,125,27.17
3502,35,2,472,370,78.39,102,21.61
3503,35,3,424,314,74.06,110,25.94
3504,35,4,473,365,77.17,108,22.83
3505,35,5,391,299,76.47,92,23.53
3506,35,6,490,374,76.33,116,23.67
3507,35,7,468,345,73.72,123,26.28
3508,35,8,470,355,75.53,115,24.47
3509,35,9,409,301,73.59,108,26.41
3510,35,10,532,417,78.38,115,21.62
3511,35,11,519,397,76.49,122,23.51
3512,35,12,312,214,68.59,98,31.41
3513,35,13,323,231,71.52,92,28.48
3514,35,14,365,268,73.42,97,26.58
3515,35,15,560,435,77.68,125,22.32
3516,35,16,249,174,69.88,75,30.12
3517,35,17,459,351,76.47,108,23.53
3518,35,18,317,229,72.24,88,27.76
3519,35,19,294,216,73.47,78,26.53
3520,35,20,471,356,75.58,115,24.42
3521,35,21,473,341,72.09,132,27.91
3522,35,22,588,449,76.36,139,23.64
3523,35,23,471,361,76.65,110,23.35
3524,35,24,419,318,75.89,101,24.11
3525,35,25,475,375,78.95,100,21.05
3526,35,26,410,314,76.59,96,23.41
3527,35,27,407,321,78.87,86,21.13
3528,35,28,466,351,75.32,115,24.68
3529,35,29,445,347,77.98,98,22.02
3530,35,30,419,306,73.03,113,26.97
3531,35,31,494,393,79.55,101,20.45
3601,36,1,380,272,71.58,108,28.42
3602,36,2,372,264,70.97,108,29.03
3603,36,3,351,253,72.08,98,27.92
3604,36,4,431,327,75.87,104,24.13
3605,36,5,349,263,75.36,86,24.64
3606,36,6,345,253,73.33,92,26.67
3607,36,7,396,273,68.94,123,31.06
3608,36,8,319,230,72.1,89,27.9
3609,36,9,384,280,72.92,104,27.08
3610,36,10,503,381,75.75,122,24.25
3611,36,11,274,187,68.25,87,31.75
3612,36,12,242,183,75.62,59,24.38
3613,36,13,271,202,74.54,69,25.46
3614,36,14,423,299,70.69,124,29.31
3615,36,15,378,306,80.95,72,19.05
3616,36,16,382,282,73.82,100,26.18
3617,36,17,468,350,74.79,118,25.21
3618,36,18,407,295,72.48,112,27.52
3619,36,19,492,360,73.17,132,26.83
3620,36,20,446,336,75.34,110,24.66
3621,36,21,352,234,66.48,118,33.52
3622,36,22,363,252,69.42,111,30.58
3623,36,23,351,263,74.93,88,25.07
3624,36,24,457,342,74.84,115,25.16
3625,36,25,406,297,73.15,109,26.85
3626,36,26,363,260,71.63,103,28.37
3627,36,27,328,245,74.7,83,25.3
3628,36,28,346,250,72.25,96,27.75
3629,36,29,415,306,73.73,109,26.27
3630,36,30,369,259,70.19,110,29.81
3701,37,1,199,157,78.89,42,21.11
3702,37,2,300,210,70.0,90,30.0
3703,37,3,232,158,68.1,74,31.9
3704,37,4,264,175,66.29,89,33.71
3705,37,5,330,246,74.55,84,25.45
3706,37,6,213,161,75.59,52,24.41
3707,37,7,255,190,74.51,65,25.49
3708,37,8,226,164,72.57,62,27.43
3709,37,9,310,226,72.9,84,27.1
3710,37,10,400,288,72.0,112,28.0
3711,37,11,207,146,70.53,61,29.47
3712,37,12,299,204,68.23,95,31.77
3713,37,13,241,181,75.1,60,24.9
3714,37,14,365,252,69.04,113,30.96
3715,37,15,331,242,73.11,89,26.89
3716,37,16,350,254,72.57,96,27.43
3717,37,17,237,177,74.68,60,25.32
3718,37,18,275,190,69.09,85,30.91
3719,37,19,233,163,69.96,70,30.04
3720,37,20,282,208,73.76,74,26.24
3721,37,21,250,179,71.6,71,28.4
3722,37,22,286,206,72.03,80,27.97
3723,37,23,308,220,71.43,88,28.57
3724,37,24,299,214,71.57,85,28.43
3725,37,25,275,191,69.45,84,30.55
3726,37,26,431,300,69.61,131,30.39
3727,37,27,311,222,71.38,89,28.62
3728,37,28,278,193,69.42,85,30.58
3729,37,29,271,190,70.11,81,29.89
3730,37,30,279,201,72.04,78,27.96
3731,37,31,370,259,70.0,111,30.0
3732,37,32,280,210,75.0,70,25.0
3733,37,33,239,168,70.29,71,29.71
3734,37,34,279,194,69.53,85,30.47
3735,37,35,319,216,67.71,103,32.29
3736,37,36,220,162,73.64,58,26.36
3737,37,37,330,239,72.42,91,27.58
3738,37,38,329,233,70.82,96,29.18
3739,37,39,265,184,69.43,81,30.57
3740,37,40,331,252,76.13,79,23.87
3741,37,41,311,231,74.28,80,25.72
3801,38,1,382,301,78.8,81,21.2
3802,38,2,376,253,67.29,123,32.71
3803,38,3,399,275,68.92,124,31.08
3804,38,4,362,244,67.4,118,32.6
3805,38,5,368,255,69.29,113,30.71
3806,38,6,388,264,68.04,124,31.96
3807,38,7,373,264,70.78,109,29.22
3808,38,8,379,270,71.24,109,28.76
3809,38,9,470,333,70.85,137,29.15
3810,38,10,353,255,72.24,98,27.76
3811,38,11,359,288,80.22,71,19.78
3812,38,12,346,225,65.03,121,34.97
3813,38,13,448,317,70.76,131,29.24
3814,38,14,428,308,71.96,120,28.04
3815,38,15,368,283,76.9,85,23.1
3816,38,16,387,270,69.77,117,30.23
3817,38,17,461,308,66.81,153,33.19
3818,38,18,401,293,73.07,108,26.93
3819,38,19,424,330,77.83,94,22.17
3820,38,20,402,278,69.15,124,30.85
3821,38,21,398,291,73.12,107,26.88
3822,38,22,363,284,78.24,79,21.76
3823,38,23,413,304,73.61,109,26.39
3824,38,24,382,279,73.04,103,26.96
3825,38,25,376,271,72.07,105,27.93
3826,38,26,407,311,76.41,96,23.59
3827,38,27,386,260,67.36,126,32.64
3828,38,28,486,331,68.11,155,31.89
3829,38,29,410,292,71.22,118,28.78
3830,38,30,393,264,67.18,129,32.82
3831,38,31,416,334,80.29,82,19.71
3832,38,32,383,298,77.81,85,22.19
3833,38,33,335,255,76.12,80,23.88
3834,38,34,365,262,71.78,103,28.22
3835,38,35,379,276,72.82,103,27.18
3836,38,36,379,300,79.16,79,20.84
3837,38,37,387,258,66.67,129,33.33
3838,38,38,388,276,71.13,112,28.87
3839,38,39,431,330,76.57,101,23.43
3840,38,40,412,306,74.27,106,25.73
3841,38,41,349,274,78.51,75,21.49
3901,39,1,379,277,73.09,102,26.91
3902,39,2,257,221,85.99,36,14.01
3903,39,3,470,387,82.34,83,17.66
3904,39,4,398,291,73.12,107,26.88
3905,39,5,432,336,77.78,96,22.22
3906,39,6,442,322,72.85,120,27.15
3907,39,7,373,300,80.43,73,19.57
3908,39,8,427,342,80.09,85,19.91
3909,39,9,380,305,80.26,75,19.74
3910,39,10,192,164,85.42,28,14.58
3911,39,11,395,309,78.23,86,21.77
3912,39,12,563,420,74.6,143,25.4
3913,39,13,334,258,77.25,76,22.75
3914,39,14,421,315,74.82,106,25.18
3915,39,15,465,350,75.27,115,24.73
3916,39,16,379,289,76.25,90,23.75
3917,39,17,416,335,80.53,81,19.47
3918,39,18,412,328,79.61,84,20.39
3919,39,19,401,318,79.3,83,20.7
3920,39,20,514,374,72.76,140,27.24
3921,39,21,409,272,66.5,137,33.5
3922,39,22,416,329,79.09,87,20.91
3923,39,23,412,306,74.27,106,25.73
3924,39,24,503,363,72.17,140,27.83
3925,39,25,352,281,79.83,71,20.17
3926,39,26,368,274,74.46,94,25.54
3927,39,27,56,43,76.79,13,23.21
3928,39,28,531,418,78.72,113,21.28
3929,39,29,218,170,77.98,48,22.02
3930,39,30,518,437,84.36,81,15.64
3931,39,31,372,281,75.54,91,24.46
3932,39,32,304,227,74.67,77,25.33
3933,39,33,425,336,79.06,89,20.94
3934,39,34,490,358,73.06,132,26.94
3935,39,35,414,341,82.37,73,17.63
3936,39,36,103,89,86.41,14,13.59
3937,39,37,370,311,84.05,59,15.95
3938,39,38,210,179,85.24,31,14.76
3939,39,39,252,200,79.37,52,20.63
3940,39,40,418,305,72.97,113,27.03
3941,39,41,415,328,79.04,87,20.96
3942,39,42,421,330,78.38,91,21.62
3943,39,43,423,304,71.87,119,28.13
3944,39,44,330,248,75.15,82,24.85
3945,39,45,355,268,75.49,87,24.51
4001,40,1,419,333,79.47,86,20.53
4002,40,2,490,404,82.45,86,17.55
4003,40,3,603,508,84.25,95,15.75
4004,40,4,290,238,82.07,52,17.93
4005,40,5,536,445,83.02,91,16.98
4006,40,6,560,463,82.68,97,17.32
4007,40,7,455,379,83.3,76,16.7
4008,40,8,629,524,83.31,105,16.69
4009,40,9,369,302,81.84,67,18.16
4010,40,10,525,402,76.57,123,23.43
4011,40,11,488,400,81.97,88,18.03
4012,40,12,402,342,85.07,60,14.93
4013,40,13,709,562,79.27,147,20.73
4014,40,14,431,332,77.03,99,22.97
4015,40,15,450,359,79.78,91,20.22
4016,40,16,635,500,78.74,135,21.26
4017,40,17,388,320,82.47,68,17.53
4018,40,18,373,303,81.23,70,18.77
4019,40,19,576,437,75.87,139,24.13
4020,40,20,490,377,76.94,113,23.06
4021,40,21,547,468,85.56,79,14.44
4022,40,22,590,491,83.22,99,16.78
4023,40,23,584,492,84.25,92,15.75
4024,40,24,437,342,78.26,95,21.74
4025,40,25,566,462,81.63,104,18.37
4026,40,26,506,433,85.57,73,14.43
4027,40,27,589,477,80.98,112,19.02
4028,40,28,516,406,78.68,110,21.32
4029,40,29,490,382,77.96,108,22.04
4030,40,30,384,304,79.17,80,20.83
4031,40,31,535,450,84.11,85,15.89
4032,40,32,535,456,85.23,79,14.77
4033,40,33,467,390,83.51,77,16.49
4034,40,34,400,320,80.0,80,20.0
4035,40,35,329,266,80.85,63,19.15
4036,40,36,406,343,84.48,63,15.52
4037,40,37,502,400,79.68,102,20.32
4038,40,38,606,497,82.01,109,17.99
4039,40,39,191,139,72.77,52,27.23
4101,41,1,413,253,61.26,160,38.74
4102,41,2,458,296,64.63,162,35.37
4103,41,3,420,291,69.29,129,30.71
4104,41,4,413,307,74.33,106,25.67
4105,41,5,501,364,72.65,137,27.35
4106,41,6,493,378,76.67,115,23.33
4107,41,7,439,304,69.25,135,30.75
4108,41,8,434,287,66.13,147,33.87
4109,41,9,379,267,70.45,112,29.55
4110,41,10,429,310,72.26,119,27.74
4111,41,11,461,282,61.17,179,38.83
4112,41,12,457,332,72.65,125,27.35
4113,41,13,477,319,66.88,158,33.12
4114,41,14,451,335,74.28,116,25.72
4115,41,15,516,386,74.81,130,25.19
4116,41,16,416,291,69.95,125,30.05
4117,41,17,374,255,68.18,119,31.82
4118,41,18,380,258,67.89,122,32.11
4119,41,19,446,357,80.04,89,19.96
4120,41,20,317,217,68.45,100,31.55
4121,41,21,453,320,70.64,133,29.36
4122,41,22,489,331,67.69,158,32.31
4123,41,23,403,265,65.76,138,34.24
4124,41,24,409,256,62.59,153,37.41
4125,41,25,385,251,65.19,134,34.81
4126,41,26,399,276,69.17,123,30.83
4127,41,27,371,242,65.23,129,34.77
4128,41,28,406,289,71.18,117,28.82
4129,41,29,340,244,71.76,96,28.24
4130,41,30,377,269,71.35,108,28.65
4131,41,31,384,292,76.04,92,23.96
4132,41,32,376,265,70.48,111,29.52
4133,41,33,399,272,68.17,127,31.83
4134,41,34,387,259,66.93,128,33.07
4135,41,35,488,312,63.93,176,36.07
4136,41,36,429,277,64.57,152,35.43
4137,41,37,480,375,78.13,105,21.88
4138,41,38,412,281,68.2,131,31.8
4139,41,39,428,284,66.36,144,33.64
4140,41,40,466,292,62.66,174,37.34
4141,41,41,452,319,70.58,133,29.42
4142,41,42,419,283,67.54,136,32.46
4143,41,43,405,281,69.38,124,30.62
4144,41,44,429,280,65.27,149,34.73
4145,41,45,434,306,70.51,128,29.49
4146,41,46,423,287,67.85,136,32.15
4147,41,47,416,297,71.39,119,28.61
4201,42,1,404,348,86.14,56,13.86
4202,42,2,593,512,86.34,81,13.66
4203,42,3,509,438,86.05,71,13.95
4204,42,4,1144,983,85.93,161,14.07
4205,42,5,391,338,86.45,53,13.55
4206,42,6,461,390,84.6,71,15.4
4207,42,7,573,489,85.34,84,14.66
4208,42,8,379,303,79.95,76,20.05
4209,42,9,675,547,81.04,128,18.96
4210,42,10,699,580,82.98,119,17.02
4211,42,11,318,274,86.16,44,13.84
4212,42,12,391,334,85.42,57,14.58
4213,42,13,382,320,83.77,62,16.23
4214,42,14,674,580,86.05,94,13.95
4215,42,15,654,548,83.79,106,16.21
4216,42,16,498,418,83.94,80,16.06
4217,42,17,779,663,85.11,116,14.89
4218,42,18,647,550,85.01,97,14.99
4219,42,19,604,514,85.1,90,14.9
4220,42,20,586,480,81.91,106,18.09
4221,42,21,623,537,86.2,86,13.8
4222,42,22,275,232,84.36,43,15.64
4223,42,23,508,419,82.48,89,17.52
4224,42,24,431,373,86.54,58,13.46
4225,42,25,567,451,79.54,116,20.46
4226,42,26,790,668,84.56,122,15.44
4227,42,27,340,263,77.35,77,22.65
4228,42,28,530,430,81.13,100,18.87
4229,42,29,599,493,82.3,106,17.7
4230,42,30,371,317,85.44,54,14.56
4231,42,31,567,474,83.6,93,16.4
4232,42,32,598,490,81.94,108,18.06
4233,42,33,564,462,81.91,102,18.09
4234,42,34,377,312,82.76,65,17.24
4235,42,35,608,501,82.4,107,17.6
4236,42,36,899,732,81.42,167,18.58
4237,42,37,387,322,83.2,65,16.8
4238,42,38,483,406,84.06,77,15.94
4239,42,39,881,760,86.27,121,13.73
4240,42,40,734,629,85.69,105,14.31
4241,42,41,523,443,84.7,80,15.3
4242,42,42,879,760,86.46,119,13.54
4301,43,1,247,212,85.83,35,14.17
4302,43,2,532,459,86.28,73,13.72
4303,43,3,458,400,87.34,58,12.66
4304,43,4,558,482,86.38,76,13.62
4305,43,5,445,384,86.29,61,13.71
4306,43,6,389,344,88.43,45,11.57
4307,43,7,282,251,89.01,31,10.99
4308,43,8,371,321,86.52,50,13.48
4309,43,9,465,388,83.44,77,16.56
4310,43,10,579,506,87.39,73,12.61
4311,43,11,454,395,87.0,59,13.0
4312,43,12,316,268,84.81,48,15.19
4313,43,13,490,422,86.12,68,13.88
4314,43,14,495,432,87.27,63,12.73
4315,43,15,468,390,83.33,78,16.67
4316,43,16,654,553,84.56,101,15.44
4317,43,17,388,337,86.86,51,13.14
4318,43,18,538,462,85.87,76,14.13
4319,43,19,472,425,90.04,47,9.96
4320,43,20,592,511,86.32,81,13.68
4321,43,21,553,463,83.73,90,16.27
4322,43,22,336,285,84.82,51,15.18
4323,43,23,339,293,86.43,46,13.57
4324,43,24,365,308,84.38,57,15.62
4325,43,25,397,334,84.13,63,15.87
4326,43,26,289,252,87.2,37,12.8
4327,43,27,444,381,85.81,63,14.19
4328,43,28,584,506,86.64,78,13.36
4329,43,29,675,590,87.41,85,12.59
4330,43,30,509,433,85.07,76,14.93
4331,43,31,449,371,82.63,78,17.37
4332,43,32,494,444,89.88,50,10.12
4333,43,33,443,389,87.81,54,12.19
4334,43,34,321,279,86.92,42,13.08
4335,43,35,501,428,85.43,73,14.57
4336,43,36,323,270,83.59,53,16.41
4337,43,37,577,499,86.48,78,13.52
4338,43,38,325,274,84.31,51,15.69
4339,43,39,362,298,82.32,64,17.68
4340,43,40,367,308,83.92,59,16.08
4341,43,41,588,510,86.73,78,13.27
4342,43,42,452,385,85.18,67,14.82
4343,43,43,462,410,88.74,52,11.26
4344,43,44,447,384,85.91,63,14.09
4345,43,45,296,259,87.5,37,12.5
4346,43,46,290,252,86.9,38,13.1
4401,44,1,805,693,86.09,112,13.91
4402,44,2,525,455,86.67,70,13.33
4403,44,3,275,244,88.73,31,11.27
4404,44,4,397,362,91.18,35,8.82
4405,44,5,529,461,87.15,68,12.85
4406,44,6,653,571,87.44,82,12.56
4407,44,7,321,278,86.6,43,13.4
4408,44,8,723,632,87.41,91,12.59
4409,44,9,560,491,87.68,69,12.32
4410,44,10,582,496,85.22,86,14.78
4411,44,11,615,500,81.3,115,18.7
4412,44,12,549,466,84.88,83,15.12
4413,44,13,473,405,85.62,68,14.38
4414,44,14,528,455,86.17,73,13.83
4415,44,15,498,433,86.95,65,13.05
4416,44,16,629,525,83.47,104,16.53
4417,44,17,716,613,85.61,103,14.39
4418,44,18,578,502,86.85,76,13.15
4419,44,19,634,537,84.7,97,15.3
4420,44,20,669,577,86.25,92,13.75
4421,44,21,631,554,87.8,77,12.2
4422,44,22,507,434,85.6,73,14.4
4423,44,23,527,476,90.32,51,9.68
4424,44,24,356,322,90.45,34,9.55
4425,44,25,549,477,86.89,72,13.11
4426,44,26,714,612,85.71,102,14.29
4427,44,27,618,536,86.73,82,13.27
4428,44,28,591,507,85.79,84,14.21
4429,44,29,623,534,85.71,89,14.29
4430,44,30,653,558,85.45,95,14.55
4431,44,31,496,413,83.27,83,16.73
4432,44,32,623,521,83.63,102,16.37
4433,44,33,611,532,87.07,79,12.93
4434,44,34,553,488,88.25,65,11.75
4435,44,35,548,479,87.41,69,12.59
4436,44,36,629,544,86.49,85,13.51
4437,44,37,611,520,85.11,91,14.89
4438,44,38,657,540,82.19,117,17.81
4439,44,39,596,536,89.93,60,10.07
4440,44,40,511,451,88.26,60,11.74
4441,44,41,704,597,84.8,107,15.2
4501,45,1,365,294,80.55,71,19.45
4502,45,2,445,361,81.12,84,18.88
4503,45,3,392,311,79.34,81,20.66
4504,45,4,513,393,76.61,120,23.39
4505,45,5,449,361,80.4,88,19.6
4506,45,6,596,466,78.19,130,21.81
4507,45,7,622,512,82.32,110,17.68
4508,45,8,448,352,78.57,96,21.43
4509,45,9,433,318,73.44,115,26.56
4510,45,10,424,308,72.64,116,27.36
4511,45,11,342,261,76.32,81,23.68
4512,45,12,383,282,73.63,101,26.37
4513,45,13,355,288,81.13,67,18.87
4514,45,14,619,491,79.32,128,20.68
4515,45,15,519,422,81.31,97,18.69
4516,45,16,355,291,81.97,64,18.03
4517,45,17,459,346,75.38,113,24.62
4518,45,18,463,346,74.73,117,25.27
4519,45,19,236,185,78.39,51,21.61
4520,45,20,294,218,74.15,76,25.85
4521,45,21,372,270,72.58,102,27.42
4522,45,22,390,311,79.74,79,20.26
4523,45,23,398,283,71.11,115,28.89
4524,45,24,334,235,70.36,99,29.64
4525,45,25,282,194,68.79,88,31.21
4526,45,26,240,177,73.75,63,26.25
4527,45,27,411,302,73.48,109,26.52
4528,45,28,346,264,76.3,82,23.7
4529,45,29,271,207,76.38,64,23.62
4530,45,30,422,328,77.73,94,22.27
4531,45,31,342,267,78.07,75,21.93
4532,45,32,403,294,72.95,109,27.05
4533,45,33,302,234,77.48,68,22.52
4534,45,34,451,348,77.16,103,22.84
4535,45,35,470,349,74.26,121,25.74
4536,45,36,438,317,72.37,121,27.63
4537,45,37,405,294,72.59,111,27.41
4538,45,38,414,304,73.43,110,26.57
4539,45,39,416,311,74.76,105,25.24
4540,45,40,394,277,70.3,117,29.7
4541,45,41,372,266,71.51,106,28.49
4542,45,42,399,306,76.69,93,23.31
4543,45,43,446,329,73.77,117,26.23
4544,45,44,384,278,72.4,106,27.6
4545,45,45,274,175,63.87,99,36.13
4546,45,46,333,215,64.56,118,35.44
4547,45,47,301,219,72.76,82,27.24
4548,45,48,326,230,70.55,96,29.45
4601,46,1,399,311,77.94,88,22.06
4602,46,2,512,420,82.03,92,17.97
4603,46,3,584,506,86.64,78,13.36
4604,46,4,497,413,83.1,84,16.9
4605,46,5,681,557,81.79,124,18.21
4606,46,6,440,357,81.14,83,18.86
4607,46,7,483,411,85.09,72,14.91
4608,46,8,346,270,78.03,76,21.97
4609,46,9,582,483,82.99,99,17.01
4610,46,10,887,756,85.23,131,14.77
4611,46,11,489,391,79.96,98,20.04
4612,46,12,557,454,81.51,103,18.49
4613,46,13,539,465,86.27,74,13.73
4614,46,14,533,417,78.24,116,21.76
4615,46,15,518,447,86.29,71,13.71
4616,46,16,594,497,83.67,97,16.33
4617,46,17,545,455,83.49,90,16.51
4618,46,18,581,469,80.72,112,19.28
4619,46,19,342,283,82.75,59,17.25
4620,46,20,437,361,82.61,76,17.39
4621,46,21,390,313,80.26,77,19.74
4622,46,22,365,282,77.26,83,22.74
4623,46,23,484,407,84.09,77,15.91
4624,46,24,650,552,84.92,98,15.08
4625,46,25,502,410,81.67,92,18.33
4626,46,26,717,569,79.36,148,20.64
4627,46,27,674,541,80.27,133,19.73
4628,46,28,473,412,87.1,61,12.9
4629,46,29,406,347,85.47,59,14.53
4630,46,30,529,436,82.42,93,17.58
4631,46,31,529,453,85.63,76,14.37
4632,46,32,487,378,77.62,109,22.38
4633,46,33,523,463,88.53,60,11.47
4634,46,34,669,555,82.96,114,17.04
4635,46,35,584,485,83.05,99,16.95
4636,46,36,485,411,84.74,74,15.26
4637,46,37,413,339,82.08,74,17.92
4638,46,38,596,499,83.72,97,16.28
4639,46,39,468,375,80.13,93,19.87
4640,46,40,441,377,85.49,64,14.51
4701,47,1,374,309,82.62,65,17.38
4702,47,2,509,425,83.5,84,16.5
4703,47,3,495,434,87.68,61,12.32
4704,47,4,635,548,86.3,87,13.7
4705,47,5,582,467,80.24,115,19.76
4706,47,6,642,569,88.63,73,11.37
4707,47,7,498,397,79.72,101,20.28
4708,47,8,533,451,84.62,82,15.38
4709,47,9,498,421,84.54,77,15.46
4710,47,10,648,529,81.64,119,18.36
4711,47,11,543,463,85.27,80,14.73
4712,47,12,581,491,84.51,90,15.49
4713,47,13,520,428,82.31,92,17.69
4714,47,14,494,435,88.06,59,11.94
4715,47,15,671,535,79.73,136,20.27
4716,47,16,533,455,85.37,78,14.63
4717,47,17,532,435,81.77,97,18.23
4718,47,18,522,434,83.14,88,16.86
4719,47,19,827,682,82.47,145,17.53
4720,47,20,569,482,84.71,87,15.29
4721,47,21,511,420,82.19,91,17.81
4722,47,22,582,489,84.02,93,15.98
4723,47,23,610,515,84.43,95,15.57
4724,47,24,551,473,85.84,78,14.16
4725,47,25,652,556,85.28,96,14.72
4726,47,26,732,639,87.3,93,12.7
4727,47,27,461,401,86.98,60,13.02
4728,47,28,496,410,82.66,86,17.34
4729,47,29,635,553,87.09,82,12.91
4730,47,30,675,576,85.33,99,14.67
4731,47,31,591,476,80.54,115,19.46
4732,47,32,660,562,85.15,98,14.85
4733,47,33,517,444,85.88,73,14.12
4734,47,34,562,487,86.65,75,13.35
4735,47,35,529,443,83.74,86,16.26
4736,47,36,630,527,83.65,103,16.35
4737,47,37,496,399,80.44,97,19.56
4738,47,38,541,466,86.14,75,13.86
4739,47,39,531,448,84.37,83,15.63
4740,47,40,501,421,84.03,80,15.97
4741,47,41,596,493,82.72,103,17.28
4742,47,42,525,431,82.1,94,17.9
4743,47,43,479,419,87.47,60,12.53
4744,47,44,458,383,83.62,75,16.38
4745,47,45,514,446,86.77,68,13.23
4746,47,46,550,455,82.73,95,17.27
4747,47,47,657,558,84.93,99,15.07
4748,47,48,32,22,68.75,10,31.25
4801,48,1,504,407,80.75,97,19.25
4802,48,2,211,185,87.68,26,12.32
4803,48,3,576,478,82.99,98,17.01
4804,48,4,450,378,84.0,72,16.0
4805,48,5,242,205,84.71,37,15.29
4806,48,6,589,486,82.51,103,17.49
4807,48,7,532,462,86.84,70,13.16
4808,48,8,246,205,83.33,41,16.67
4809,48,9,319,259,81.19,60,18.81
4810,48,10,696,611,87.79,85,12.21
4811,48,11,400,339,84.75,61,15.25
4812,48,12,591,484,81.9,107,18.1
4813,48,13,613,517,84.34,96,15.66
4814,48,14,203,162,79.8,41,20.2
4815,48,15,320,264,82.5,56,17.5
4816,48,16,550,430,78.18,120,21.82
4817,48,17,425,360,84.71,65,15.29
4818,48,18,329,262,79.64,67,20.36
4819,48,19,351,301,85.75,50,14.25
4820,48,20,546,432,79.12,114,20.88
4821,48,21,643,507,78.85,136,21.15
4822,48,22,364,311,85.44,53,14.56
4823,48,23,431,374,86.77,57,13.23
4824,48,24,578,405,70.07,173,29.93
4825,48,25,430,374,86.98,56,13.02
4826,48,26,245,192,78.37,53,21.63
4827,48,27,492,400,81.3,92,18.7
4828,48,28,525,415,79.05,110,20.95
4829,48,29,183,171,93.44,12,6.56
4830,48,30,417,340,81.53,77,18.47
4831,48,31,718,570,79.39,148,20.61
4832,48,32,536,436,81.34,100,18.66
4833,48,33,255,229,89.8,26,10.2
4834,48,34,417,355,85.13,62,14.87
4835,48,35,293,227,77.47,66,22.53
4836,48,36,273,238,87.18,35,12.82
4837,48,37,512,423,82.62,89,17.38
4838,48,38,506,441,87.15,65,12.85
4839,48,39,363,307,84.57,56,15.43
4840,48,40,456,396,86.84,60,13.16
4841,48,41,650,504,77.54,146,22.46
4842,48,42,578,490,84.78,88,15.22
4843,48,43,579,475,82.04,104,17.96
4844,48,44,639,533,83.41,106,16.59
4845,48,45,377,311,82.49,66,17.51
4846,48,46,288,235,81.6,53,18.4
4901,49,1,339,253,74.63,86,25.37
4902,49,2,312,267,85.58,45,14.42
4903,49,3,635,530,83.46,105,16.54
4904,49,4,680,533,78.38,147,21.62
4905,49,5,496,420,84.68,76,15.32
4906,49,6,441,360,81.63,81,18.37
4907,49,7,404,313,77.48,91,22.52
4908,49,8,452,385,85.18,67,14.82
4909,49,9,518,426,82.24,92,17.76
4910,49,10,590,487,82.54,103,17.46
4911,49,11,664,545,82.08,119,17.92
4912,49,12,636,525,82.55,111,17.45
4913,49,13,585,461,78.8,124,21.2
4914,49,14,390,305,78.21,85,21.79
4915,49,15,379,307,81.0,72,19.0
4916,49,16,461,368,79.83,93,20.17
4917,49,17,391,320,81.84,71,18.16
4918,49,18,653,512,78.41,141,21.59
4919,49,19,479,381,79.54,98,20.46
4920,49,20,762,613,80.45,149,19.55
4921,49,21,316,246,77.85,70,22.15
4922,49,22,534,425,79.59,109,20.41
4923,49,23,670,528,78.81,142,21.19
4924,49,24,398,322,80.9,76,19.1
4925,49,25,648,515,79.48,133,20.52
4926,49,26,577,464,80.42,113,19.58
4927,49,27,598,482,80.6,116,19.4
4928,49,28,735,565,76.87,170,23.13
4929,49,29,596,468,78.52,128,21.48
4930,49,30,534,429,80.34,105,19.66
4931,49,31,354,280,79.1,74,20.9
4932,49,32,491,354,72.1,137,27.9
4933,49,33,395,318,80.51,77,19.49
5001,50,1,319,254,79.62,65,20.38
5002,50,2,217,175,80.65,42,19.35
5003,50,3,295,248,84.07,47,15.93
5004,50,4,401,334,83.29,67,16.71
5005,50,5,210,169,80.48,41,19.52
5006,50,6,396,328,82.83,68,17.17
5007,50,7,486,406,83.54,80,16.46
5008,50,8,375,299,79.73,76,20.27
5009,50,9,315,247,78.41,68,21.59
5010,50,10,373,277,74.26,96,25.74
5011,50,11,175,123,70.29,52,29.71
5012,50,12,142,109,76.76,33,23.24
5013,50,13,462,377,81.6,85,18.4
5014,50,14,107,79,73.83,28,26.17
5015,50,15,477,402,84.28,75,15.72
5016,50,16,95,72,75.79,23,24.21
5017,50,17,380,313,82.37,67,17.63
5018,50,18,45,34,75.56,11,24.44
5019,50,19,325,266,81.85,59,18.15
5020,50,20,423,325,76.83,98,23.17
5021,50,21,345,287,83.19,58,16.81
5022,50,22,325,258,79.38,67,20.62
5023,50,23,250,183,73.2,67,26.8
5024,50,24,216,145,67.13,71,32.87
5025,50,25,290,222,76.55,68,23.45
5026,50,26,413,313,75.79,100,24.21
5027,50,27,96,72,75.0,24,25.0
5028,50,28,424,343,80.9,81,19.1
5029,50,29,402,327,81.34,75,18.66
5030,50,30,321,274,85.36,47,14.64
5031,50,31,546,429,78.57,117,21.43
5032,50,32,432,351,81.25,81,18.75
5033,50,33,220,169,76.82,51,23.18
5034,50,34,453,360,79.47,93,20.53
5035,50,35,529,438,82.8,91,17.2
5036,50,36,388,316,81.44,72,18.56
5037,50,37,400,330,82.5,70,17.5
5038,50,38,117,89,76.07,28,23.93
5039,50,39,225,173,76.89,52,23.11
5040,50,40,245,179,73.06,66,26.94
