id,ward,precinct,total,Yes,Yes Percent,No,No Percent
0101,1,1,510,408,80.0,102,20.0
0102,1,2,471,391,83.01,80,16.99
0103,1,3,599,516,86.14,83,13.86
0104,1,4,576,492,85.42,84,14.58
0105,1,5,510,437,85.69,73,14.31
0106,1,6,437,366,83.75,71,16.25
0107,1,7,369,308,83.47,61,16.53
0108,1,8,422,357,84.6,65,15.4
0109,1,9,363,292,80.44,71,19.56
0110,1,10,626,517,82.59,109,17.41
0111,1,11,571,502,87.92,69,12.08
0112,1,12,604,491,81.29,113,18.71
0113,1,13,251,204,81.27,47,18.73
0114,1,14,462,381,82.47,81,17.53
0115,1,15,471,391,83.01,80,16.99
0116,1,16,554,456,82.31,98,17.69
0117,1,17,434,354,81.57,80,18.43
0118,1,18,499,418,83.77,81,16.23
0119,1,19,609,497,81.61,112,18.39
0120,1,20,404,344,85.15,60,14.85
0121,1,21,681,594,87.22,87,12.78
0122,1,22,333,256,76.88,77,23.12
0123,1,23,660,552,83.64,108,16.36
0124,1,24,455,362,79.56,93,20.44
0125,1,25,494,410,83.0,84,17.0
0126,1,26,341,245,71.85,96,28.15
0127,1,27,568,473,83.27,95,16.73
0128,1,28,166,126,75.9,40,24.1
0129,1,29,623,542,87.0,81,13.0
0130,1,30,567,449,79.19,118,20.81
0131,1,31,458,369,80.57,89,19.43
0132,1,32,480,388,80.83,92,19.17
0133,1,33,542,456,84.13,86,15.87
0134,1,34,419,369,88.07,50,11.93
0135,1,35,627,504,80.38,123,19.62
0136,1,36,584,496,84.93,88,15.07
0137,1,37,494,419,84.82,75,15.18
0138,1,38,483,411,85.09,72,14.91
0139,1,39,430,358,83.26,72,16.74
0140,1,40,436,363,83.26,73,16.74
0141,1,41,281,243,86.48,38,13.52
0142,1,42,176,144,81.82,32,18.18
0143,1,43,325,273,84.0,52,16.0
0144,1,44,459,386,84.1,73,15.9
0201,2,1,557,460,82.59,97,17.41
0202,2,2,336,281,83.63,55,16.37
0203,2,3,570,472,82.81,98,17.19
0204,2,4,489,409,83.64,80,16.36
0205,2,5,623,508,81.54,115,18.46
0206,2,6,530,433,81.7,97,18.3
0207,2,7,439,371,84.51,68,15.49
0208,2,8,626,519,82.91,107,17.09
0209,2,9,454,388,85.46,66,14.54
0210,2,10,343,287,83.67,56,16.33
0211,2,11,456,380,83.33,76,16.67
0212,2,12,393,331,84.22,62,15.78
0213,2,13,384,325,84.64,59,15.36
0214,2,14,493,428,86.82,65,13.18
0215,2,15,440,383,87.05,57,12.95
0216,2,16,490,427,87.14,63,12.86
0217,2,17,584,491,84.08,93,15.92
0218,2,18,426,360,84.51,66,15.49
0219,2,19,297,238,80.13,59,19.87
0220,2,20,579,500,86.36,79,13.64
0221,2,21,525,449,85.52,76,14.48
0222,2,22,471,413,87.69,58,12.31
0223,2,23,299,262,87.63,37,12.37
0224,2,24,412,356,86.41,56,13.59
0225,2,25,537,457,85.1,80,14.9
0226,2,26,378,315,83.33,63,16.67
0227,2,27,400,318,79.5,82,20.5
0228,2,28,518,448,86.49,70,13.51
0229,2,29,505,421,83.37,84,16.63
0230,2,30,403,346,85.86,57,14.14
0231,2,31,526,447,84.98,79,15.02
0232,2,32,420,338,80.48,82,19.52
0233,2,33,639,549,85.92,90,14.08
0234,2,34,333,291,87.39,42,12.61
0235,2,35,606,514,84.82,92,15.18
0236,2,36,481,404,83.99,77,16.01
0237,2,37,400,329,82.25,71,17.75
0238,2,38,410,342,83.41,68,16.59
0239,2,39,320,247,77.19,73,22.81
0240,2,40,651,545,83.72,106,16.28
0241,2,41,552,457,82.79,95,17.21
0242,2,42,525,450,85.71,75,14.29
0243,2,43,624,537,86.06,87,13.94
0244,2,44,286,247,86.36,39,13.64
0245,2,45,540,446,82.59,94,17.41
0246,2,46,247,203,82.19,44,17.81
0301,3,1,633,473,74.72,160,25.28
0302,3,2,454,365,80.4,89,19.6
0303,3,3,372,270,72.58,102,27.42
0304,3,4,533,415,77.86,118,22.14
0305,3,5,268,199,74.25,69,25.75
0306,3,6,653,523,80.09,130,19.91
0307,3,7,256,198,77.34,58,22.66
0308,3,8,359,260,72.42,99,27.58
0309,3,9,532,385,72.37,147,27.63
0310,3,10,209,143,68.42,66,31.58
0311,3,11,528,396,75.0,132,25.0
0312,3,12,419,330,78.76,89,21.24
0313,3,13,540,445,82.41,95,17.59
0314,3,14,536,443,82.65,93,17.35
0315,3,15,440,316,71.82,124,28.18
0316,3,16,388,289,74.48,99,25.52
0317,3,17,681,544,79.88,137,20.12
0318,3,18,614,453,73.78,161,26.22
0319,3,19,573,481,83.94,92,16.06
0320,3,20,508,371,73.03,137,26.97
0321,3,21,486,406,83.54,80,16.46
0322,3,22,671,527,78.54,144,21.46
0323,3,23,379,274,72.3,105,27.7
0324,3,24,411,309,75.18,102,24.82
0325,3,25,784,660,84.18,124,15.82
0326,3,26,507,432,85.21,75,14.79
0327,3,27,605,497,82.15,108,17.85
0328,3,28,220,157,71.36,63,28.64
0329,3,29,475,336,70.74,139,29.26
0330,3,30,388,293,75.52,95,24.48
0331,3,31,542,401,73.99,141,26.01
0332,3,32,752,622,82.71,130,17.29
0333,3,33,592,495,83.61,97,16.39
0334,3,34,708,581,82.06,127,17.94
0335,3,35,254,183,72.05,71,27.95
0336,3,36,219,153,69.86,66,30.14
0337,3,37,449,317,70.6,132,29.4
0338,3,38,325,259,79.69,66,20.31
0339,3,39,943,790,83.78,153,16.22
0340,3,40,493,387,78.5,106,21.5
0341,3,41,324,252,77.78,72,22.22
0401,4,1,700,584,83.43,116,16.57
0402,4,2,645,549,85.12,96,14.88
0403,4,3,395,295,74.68,100,25.32
0404,4,4,641,480,74.88,161,25.12
0405,4,5,508,395,77.76,113,22.24
0406,4,6,521,411,78.89,110,21.11
0407,4,7,623,488,78.33,135,21.67
0408,4,8,534,400,74.91,134,25.09
0409,4,9,510,435,85.29,75,14.71
0410,4,10,623,489,78.49,134,21.51
0411,4,11,484,373,77.07,111,22.93
0412,4,12,662,492,74.32,170,25.68
0413,4,13,637,525,82.42,112,17.58
0414,4,14,493,383,77.69,110,22.31
0415,4,15,562,448,79.72,114,20.28
0416,4,16,853,729,85.46,124,14.54
0417,4,17,567,482,85.01,85,14.99
0418,4,18,464,347,74.78,117,25.22
0419,4,19,322,211,65.53,111,34.47
0420,4,20,370,323,87.3,47,12.7
0421,4,21,555,439,79.1,116,20.9
0422,4,22,446,375,84.08,71,15.92
0423,4,23,593,494,83.31,99,16.69
0424,4,24,456,371,81.36,85,18.64
0425,4,25,603,483,80.1,120,19.9
0426,4,26,439,334,76.08,105,23.92
0427,4,27,657,538,81.89,119,18.11
0428,4,28,434,331,76.27,103,23.73
0429,4,29,471,374,79.41,97,20.59
0430,4,30,672,495,73.66,177,26.34
0431,4,31,409,335,81.91,74,18.09
0432,4,32,554,423,76.35,131,23.65
0433,4,33,453,355,78.37,98,21.63
0434,4,34,440,342,77.73,98,22.27
0435,4,35,580,450,77.59,130,22.41
0436,4,36,591,470,79.53,121,20.47
0437,4,37,926,802,86.61,124,13.39
0438,4,38,543,426,78.45,117,21.55
0501,5,1,435,310,71.26,125,28.74
0502,5,2,344,244,70.93,100,29.07
0503,5,3,447,409,91.5,38,8.5
0504,5,4,595,490,82.35,105,17.65
0505,5,5,395,290,73.42,105,26.58
0506,5,6,342,254,74.27,88,25.73
0507,5,7,430,331,76.98,99,23.02
0508,5,8,438,406,92.69,32,7.31
0509,5,9,517,438,84.72,79,15.28
0510,5,10,369,252,68.29,117,31.71
0511,5,11,445,387,86.97,58,13.03
0512,5,12,284,206,72.54,78,27.46
0513,5,13,403,286,70.97,117,29.03
0514,5,14,362,285,78.73,77,21.27
0515,5,15,423,339,80.14,84,19.86
0516,5,16,438,307,70.09,131,29.91
0517,5,17,360,267,74.17,93,25.83
0518,5,18,418,350,83.73,68,16.27
0519,5,19,414,365,88.16,49,11.84
0520,5,20,475,405,85.26,70,14.74
0521,5,21,444,376,84.68,68,15.32
0522,5,22,520,443,85.19,77,14.81
0523,5,23,777,660,84.94,117,15.06
0524,5,24,572,472,82.52,100,17.48
0525,5,25,388,317,81.7,71,18.3
0526,5,26,450,330,73.33,120,26.67
0527,5,27,411,376,91.48,35,8.52
0528,5,28,458,346,75.55,112,24.45
0529,5,29,467,339,72.59,128,27.41
0530,5,30,291,192,65.98,99,34.02
0531,5,31,337,260,77.15,77,22.85
0532,5,32,498,387,77.71,111,22.29
0533,5,33,414,310,74.88,104,25.12
0534,5,34,437,393,89.93,44,10.07
0535,5,35,554,485,87.55,69,12.45
0536,5,36,257,194,75.49,63,24.51
0537,5,37,456,406,89.04,50,10.96
0538,5,38,410,292,71.22,118,28.78
0539,5,39,361,320,88.64,41,11.36
0540,5,40,352,263,74.72,89,25.28
0541,5,41,182,159,87.36,23,12.64
0601,6,1,384,299,77.86,85,22.14
0602,6,2,375,291,77.6,84,22.4
0603,6,3,358,277,77.37,81,22.63
0604,6,4,264,187,70.83,77,29.17
0605,6,5,233,149,63.95,84,36.05
0606,6,6,432,319,73.84,113,26.16
0607,6,7,368,250,67.93,118,32.07
0608,6,8,370,289,78.11,81,21.89
0609,6,9,388,289,74.48,99,25.52
0610,6,10,248,171,68.95,77,31.05
0611,6,11,326,245,75.15,81,24.85
0612,6,12,276,194,70.29,82,29.71
0613,6,13,272,205,75.37,67,24.63
0614,6,14,334,233,69.76,101,30.24
0615,6,15,310,210,67.74,100,32.26
0616,6,16,384,279,72.66,105,27.34
0617,6,17,242,174,71.9,68,28.1
0618,6,18,265,203,76.6,62,23.4
0619,6,19,295,204,69.15,91,30.85
0620,6,20,238,183,76.89,55,23.11
0621,6,21,174,112,64.37,62,35.63
0622,6,22,213,149,69.95,64,30.05
0623,6,23,165,108,65.45,57,34.55
0624,6,24,191,132,69.11,59,30.89
0625,6,25,186,131,70.43,55,29.57
0626,6,26,260,185,71.15,75,28.85
0627,6,27,214,153,71.5,61,28.5
0628,6,28,168,120,71.43,48,28.57
0629,6,29,353,273,77.34,80,22.66
0630,6,30,314,222,70.7,92,29.3
0631,6,31,319,264,82.76,55,17.24
0632,6,32,375,277,73.87,98,26.13
0633,6,33,373,282,75.6,91,24.4
0634,6,34,370,281,75.95,89,24.05
0635,6,35,334,254,76.05,80,23.95
0636,6,36,394,298,75.63,96,24.37
0637,6,37,402,310,77.11,92,22.89
0638,6,38,396,303,76.52,93,23.48
0639,6,39,296,208,70.27,88,29.73
0640,6,40,314,238,75.8,76,24.2
0641,6,41,373,270,72.39,103,27.61
0642,6,42,342,247,72.22,95,27.78
0643,6,43,333,241,72.37,92,27.63
0644,6,44,384,280,72.92,104,27.08
0645,6,45,367,262,71.39,105,28.61
0646,6,46,279,196,70.25,83,29.75
0647,6,47,247,186,75.3,61,24.7
0648,6,48,347,265,76.37,82,23.63
0701,7,1,352,249,70.74,103,29.26
0702,7,2,333,236,70.87,97,29.13
0703,7,3,334,246,73.65,88,26.35
0704,7,4,345,266,77.1,79,22.9
0705,7,5,300,214,71.33,86,28.67
0706,7,6,437,325,74.37,112,25.63
0707,7,7,345,248,71.88,97,28.12
0708,7,8,211,147,69.67,64,30.33
0709,7,9,587,428,72.91,159,27.09
0710,7,10,346,281,81.21,65,18.79
0711,7,11,377,269,71.35,108,28.65
0712,7,12,313,222,70.93,91,29.07
0713,7,13,203,143,70.44,60,29.56
0714,7,14,395,280,70.89,115,29.11
0715,7,15,327,240,73.39,87,26.61
0716,7,16,338,227,67.16,111,32.84
0717,7,17,288,194,67.36,94,32.64
0718,7,18,309,227,73.46,82,26.54
0719,7,19,331,244,73.72,87,26.28
0720,7,20,281,206,73.31,75,26.69
0721,7,21,262,176,67.18,86,32.82
0722,7,22,301,208,69.1,93,30.9
0723,7,23,317,235,74.13,82,25.87
0724,7,24,280,201,71.79,79,28.21
0725,7,25,287,208,72.47,79,27.53
0726,7,26,270,208,77.04,62,22.96
0727,7,27,260,190,73.08,70,26.92
0728,7,28,258,181,70.16,77,29.84
0729,7,29,324,226,69.75,98,30.25
0730,7,30,278,219,78.78,59,21.22
0731,7,31,251,176,70.12,75,29.88
0732,7,32,436,331,75.92,105,24.08
0733,7,33,424,345,81.37,79,18.63
0734,7,34,432,326,75.46,106,24.54
0735,7,35,387,273,70.54,114,29.46
0736,7,36,448,338,75.45,110,24.55
0737,7,37,343,259,75.51,84,24.49
0738,7,38,315,232,73.65,83,26.35
0739,7,39,321,229,71.34,92,28.66
0740,7,40,274,212,77.37,62,22.63
0741,7,41,333,269,80.78,64,19.22
0742,7,42,342,261,76.32,81,23.68
0743,7,43,334,257,76.95,77,23.05
0744,7,44,310,234,75.48,76,24.52
0745,7,45,327,229,70.03,98,29.97
0746,7,46,81,60,74.07,21,25.93
0801,8,1,325,238,73.23,87,26.77
0802,8,2,335,246,73.43,89,26.57
0803,8,3,382,299,78.27,83,21.73
0804,8,4,413,326,78.93,87,21.07
0805,8,5,306,251,82.03,55,17.97
0806,8,6,350,273,78.0,77,22.0
0807,8,7,406,310,76.35,96,23.65
0808,8,8,363,287,79.06,76,20.94
0809,8,9,231,169,73.16,62,26.84
0810,8,10,457,362,79.21,95,20.79
0811,8,11,305,221,72.46,84,27.54
0812,8,12,312,226,72.44,86,27.56
0813,8,13,417,324,77.7,93,22.3
0814,8,14,291,181,62.2,110,37.8
0815,8,15,229,190,82.97,39,17.03
0816,8,16,106,82,77.36,24,22.64
0817,8,17,294,226,76.87,68,23.13
0818,8,18,320,234,73.13,86,26.88
0819,8,19,390,310,79.49,80,20.51
0820,8,20,413,289,69.98,124,30.02
0821,8,21,460,341,74.13,119,25.87
0822,8,22,326,245,75.15,81,24.85
0823,8,23,279,222,79.57,57,20.43
0824,8,24,190,136,71.58,54,28.42
0825,8,25,361,260,72.02,101,27.98
0826,8,26,293,204,69.62,89,30.38
0827,8,27,397,299,75.31,98,24.69
0828,8,28,368,284,77.17,84,22.83
0829,8,29,367,280,76.29,87,23.71
0830,8,30,391,300,76.73,91,23.27
0831,8,31,284,202,71.13,82,28.87
0832,8,32,283,215,75.97,68,24.03
0833,8,33,266,180,67.67,86,32.33
0834,8,34,320,251,78.44,69,21.56
0835,8,35,410,304,74.15,106,25.85
0836,8,36,354,266,75.14,88,24.86
0837,8,37,273,213,78.02,60,21.98
0838,8,38,268,206,76.87,62,23.13
0839,8,39,334,251,75.15,83,24.85
0840,8,40,282,203,71.99,79,28.01
0841,8,41,381,272,71.39,109,28.61
0842,8,42,465,337,72.47,128,27.53
0843,8,43,195,129,66.15,66,33.85
0844,8,44,250,190,76.0,60,24.0
0845,8,45,307,229,74.59,78,25.41
0846,8,46,291,213,73.2,78,26.8
0847,8,47,293,218,74.4,75,25.6
0848,8,48,309,236,76.38,73,23.62
0849,8,49,347,263,75.79,84,24.21
0850,8,50,331,255,77.04,76,22.96
0851,8,51,338,268,79.29,70,20.71
0852,8,52,440,341,77.5,99,22.5
0853,8,53,203,153,75.37,50,24.63
0854,8,54,298,205,68.79,93,31.21
0855,8,55,258,204,79.07,54,20.93
0856,8,56,375,281,74.93,94,25.07
0901,9,1,323,245,75.85,78,24.15
0902,9,2,277,198,71.48,79,28.52
0903,9,3,215,143,66.51,72,33.49
0904,9,4,247,176,71.26,71,28.74
0905,9,5,330,240,72.73,90,27.27
0906,9,6,322,240,74.53,82,25.47
0907,9,7,262,186,70.99,76,29.01
0908,9,8,351,248,70.66,103,29.34
0909,9,9,384,271,70.57,113,29.43
0910,9,10,253,193,76.28,60,23.72
0911,9,11,240,176,73.33,64,26.67
0912,9,12,370,289,78.11,81,21.89
0913,9,13,375,295,78.67,80,21.33
0914,9,14,388,291,75.0,97,25.0
0915,9,15,345,201,58.26,144,41.74
0916,9,16,342,250,73.1,92,26.9
0917,9,17,219,167,76.26,52,23.74
0918,9,18,243,171,70.37,72,29.63
0919,9,19,352,257,73.01,95,26.99
0920,9,20,312,228,73.08,84,26.92
0921,9,21,309,230,74.43,79,25.57
0922,9,22,376,284,75.53,92,24.47
0923,9,23,363,264,72.73,99,27.27
0924,9,24,348,251,72.13,97,27.87
0925,9,25,289,218,75.43,71,24.57
0926,9,26,292,212,72.6,80,27.4
0927,9,27,273,212,77.66,61,22.34
0928,9,28,225,168,74.67,57,25.33
0929,9,29,299,215,71.91,84,28.09
0930,9,30,285,207,72.63,78,27.37
0931,9,31,285,206,72.28,79,27.72
0932,9,32,346,252,72.83,94,27.17
0933,9,33,241,186,77.18,55,22.82
0934,9,34,278,195,70.14,83,29.86
0935,9,35,306,236,77.12,70,22.88
0936,9,36,299,216,72.24,83,27.76
0937,9,37,505,355,70.3,150,29.7
0938,9,38,314,219,69.75,95,30.25
0939,9,39,349,260,74.5,89,25.5
0940,9,40,372,279,75.0,93,25.0
0941,9,41,272,189,69.49,83,30.51
0942,9,42,357,267,74.79,90,25.21
0943,9,43,294,211,71.77,83,28.23
0944,9,44,318,229,72.01,89,27.99
0945,9,45,247,181,73.28,66,26.72
0946,9,46,326,248,76.07,78,23.93
0947,9,47,350,276,78.86,74,21.14
0948,9,48,339,256,75.52,83,24.48
0949,9,49,360,286,79.44,74,20.56
0950,9,50,455,345,75.82,110,24.18
0951,9,51,338,268,79.29,70,20.71
1001,10,1,277,213,76.9,64,23.1
1002,10,2,334,222,66.47,112,33.53
1003,10,3,375,239,63.73,136,36.27
1004,10,4,275,188,68.36,87,31.64
1005,10,5,285,209,73.33,76,26.67
1006,10,6,285,216,75.79,69,24.21
1007,10,7,267,190,71.16,77,28.84
1008,10,8,185,117,63.24,68,36.76
1009,10,9,337,236,70.03,101,29.97
1010,10,10,403,275,68.24,128,31.76
1011,10,11,466,341,73.18,125,26.82
1012,10,12,257,192,74.71,65,25.29
1013,10,13,325,231,71.08,94,28.92
1014,10,14,460,330,71.74,130,28.26
1015,10,15,616,456,74.03,160,25.97
1016,10,16,303,211,69.64,92,30.36
1017,10,17,468,315,67.31,153,32.69
1018,10,18,209,152,72.73,57,27.27
1019,10,19,368,252,68.48,116,31.52
1020,10,20,367,265,72.21,102,27.79
1021,10,21,360,268,74.44,92,25.56
1022,10,22,218,159,72.94,59,27.06
1023,10,23,305,228,74.75,77,25.25
1024,10,24,331,228,68.88,103,31.12
1025,10,25,104,82,78.85,22,21.15
1026,10,26,261,195,74.71,66,25.29
1027,10,27,299,216,72.24,83,27.76
1028,10,28,399,295,73.93,104,26.07
1029,10,29,379,288,75.99,91,24.01
1030,10,30,327,242,74.01,85,25.99
1031,10,31,320,228,71.25,92,28.75
1032,10,32,372,259,69.62,113,30.38
1033,10,33,287,204,71.08,83,28.92
1034,10,34,243,158,65.02,85,34.98
1035,10,35,376,258,68.62,118,31.38
1036,10,36,87,66,75.86,21,24.14
1101,11,1,374,279,74.6,95,25.4
1102,11,2,33,20,60.61,13,39.39
1103,11,3,426,337,79.11,89,20.89
1104,11,4,293,218,74.4,75,25.6
1105,11,5,561,404,72.01,157,27.99
1106,11,6,660,528,80.0,132,20.0
1107,11,7,398,319,80.15,79,19.85
1108,11,8,395,298,75.44,97,24.56
1109,11,9,370,269,72.7,101,27.3
1110,11,10,400,313,78.25,87,21.75
1111,11,11,466,332,71.24,134,28.76
1112,11,12,520,364,70.0,156,30.0
1113,11,13,472,331,70.13,141,29.87
1114,11,14,201,153,76.12,48,23.88
1115,11,15,148,118,79.73,30,20.27
1116,11,16,291,223,76.63,68,23.37
1117,11,17,506,392,77.47,114,22.53
1118,11,18,318,248,77.99,70,22.01
1119,11,19,568,429,75.53,139,24.47
1120,11,20,278,205,73.74,73,26.26
1121,11,21,484,363,75.0,121,25.0
1122,11,22,527,374,70.97,153,29.03
1123,11,23,215,166,77.21,49,22.79
1124,11,24,465,348,74.84,117,25.16
1125,11,25,505,380,75.25,125,24.75
1126,11,26,425,323,76.0,102,24.0
1127,11,27,166,130,78.31,36,21.69
1128,11,28,200,145,72.5,55,27.5
1129,11,29,487,351,72.07,136,27.93
1130,11,30,209,150,71.77,59,28.23
1131,11,31,364,270,74.18,94,25.82
1132,11,32,169,115,68.05,54,31.95
1133,11,33,539,436,80.89,103,19.11
1134,11,34,121,84,69.42,37,30.58
1135,11,35,65,50,76.92,15,23.08
1136,11,36,178,141,79.21,37,20.79
1137,11,37,114,90,78.95,24,21.05
1138,11,38,220,168,76.36,52,23.64
1201,12,1,360,251,69.72,109,30.28
1202,12,2,304,223,73.36,81,26.64
1203,12,3,453,326,71.96,127,28.04
1204,12,4,446,329,73.77,117,26.23
1205,12,5,319,233,73.04,86,26.96
1206,12,6,421,309,73.4,112,26.6
1207,12,7,355,266,74.93,89,25.07
1208,12,8,370,271,73.24,99,26.76
1209,12,9,309,240,77.67,69,22.33
1210,12,10,507,373,73.57,134,26.43
1211,12,11,401,290,72.32,111,27.68
1212,12,12,370,277,74.86,93,25.14
1213,12,13,408,304,74.51,104,25.49
1214,12,14,336,234,69.64,102,30.36
1215,12,15,333,226,67.87,107,32.13
1216,12,16,328,219,66.77,109,33.23
1217,12,17,445,334,75.06,111,24.94
1218,12,18,360,245,68.06,115,31.94
1219,12,19,358,260,72.63,98,27.37
1220,12,20,471,357,75.8,114,24.2
1221,12,21,403,290,71.96,113,28.04
1222,12,22,375,258,68.8,117,31.2
1223,12,23,384,276,71.88,108,28.13
1301,13,1,306,203,66.34,103,33.66
1302,13,2,256,180,70.31,76,29.69
1303,13,3,284,203,71.48,81,28.52
1304,13,4,369,233,63.14,136,36.86
1305,13,5,416,309,74.28,107,25.72
1306,13,6,277,184,66.43,93,33.57
1307,13,7,296,223,75.34,73,24.66
1308,13,8,268,188,70.15,80,29.85
1309,13,9,386,292,75.65,94,24.35
1310,13,10,282,161,57.09,121,42.91
1311,13,11,347,230,66.28,117,33.72
1312,13,12,313,219,69.97,94,30.03
1313,13,13,337,254,75.37,83,24.63
1314,13,14,330,241,73.03,89,26.97
1315,13,15,485,339,69.9,146,30.1
1316,13,16,257,191,74.32,66,25.68
1317,13,17,311,199,63.99,112,36.01
1318,13,18,281,186,66.19,95,33.81
1319,13,19,445,324,72.81,121,27.19
1320,13,20,228,142,62.28,86,37.72
1321,13,21,356,226,63.48,130,36.52
1322,13,22,347,253,72.91,94,27.09
1323,13,23,290,213,73.45,77,26.55
1324,13,24,353,254,71.95,99,28.05
1325,13,25,343,241,70.26,102,29.74
1326,13,26,347,249,71.76,98,28.24
1327,13,27,316,219,69.3,97,30.7
1328,13,28,264,181,68.56,83,31.44
1329,13,29,297,215,72.39,82,27.61
1330,13,30,277,206,74.37,71,25.63
1331,13,31,367,237,64.58,130,35.42
1332,13,32,292,183,62.67,109,37.33
1333,13,33,331,227,68.58,104,31.42
1334,13,34,347,267,76.95,80,23.05
1335,13,35,298,228,76.51,70,23.49
1336,13,36,255,183,71.76,72,28.24
1337,13,37,331,241,72.81,90,27.19
1338,13,38,282,186,65.96,96,34.04
1339,13,39,333,257,77.18,76,22.82
1340,13,40,310,229,73.87,81,26.13
1341,13,41,426,309,72.54,117,27.46
1342,13,42,323,207,64.09,116,35.91
1343,13,43,326,222,68.1,104,31.9
1344,13,44,357,266,74.51,91,25.49
1345,13,45,363,254,69.97,109,30.03
1346,13,46,402,294,73.13,108,26.87
1347,13,47,373,289,77.48,84,22.52
1348,13,48,270,178,65.93,92,34.07
1401,14,1,360,233,64.72,127,35.28
1402,14,2,528,398,75.38,130,24.62
1403,14,3,367,269,73.3,98,26.7
1404,14,4,349,206,59.03,143,40.97
1405,14,5,536,375,69.96,161,30.04
1406,14,6,208,146,70.19,62,29.81
1407,14,7,497,357,71.83,140,28.17
1408,14,8,464,335,72.2,129,27.8
1409,14,9,458,280,61.14,178,38.86
1410,14,10,283,194,68.55,89,31.45
1411,14,11,229,168,73.36,61,26.64
1412,14,12,397,287,72.29,110,27.71
1413,14,13,355,267,75.21,88,24.79
1414,14,14,363,272,74.93,91,25.07
1415,14,15,377,279,74.01,98,25.99
1416,14,16,266,188,70.68,78,29.32
1417,14,17,334,225,67.37,109,32.63
1418,14,18,183,136,74.32,47,25.68
1419,14,19,362,270,74.59,92,25.41
1420,14,20,306,239,78.1,67,21.9
1421,14,21,375,259,69.07,116,30.93
1422,14,22,499,347,69.54,152,30.46
1423,14,23,269,180,66.91,89,33.09
1424,14,24,409,288,70.42,121,29.58
1425,14,25,190,127,66.84,63,33.16
1426,14,26,289,201,69.55,88,30.45
1427,14,27,349,262,75.07,87,24.93
1428,14,28,334,243,72.75,91,27.25
1429,14,29,280,193,68.93,87,31.07
1430,14,30,266,197,74.06,69,25.94
1431,14,31,217,163,75.12,54,24.88
1501,15,1,325,210,64.62,115,35.38
1502,15,2,197,137,69.54,60,30.46
1503,15,3,210,158,75.24,52,24.76
1504,15,4,364,269,73.9,95,26.1
1505,15,5,341,237,69.5,104,30.5
1506,15,6,382,274,71.73,108,28.27
1507,15,7,189,129,68.25,60,31.75
1508,15,8,363,255,70.25,108,29.75
1509,15,9,479,348,72.65,131,27.35
1510,15,10,494,342,69.23,152,30.77
1511,15,11,440,308,70.0,132,30.0
1512,15,12,456,350,76.75,106,23.25
1513,15,13,368,250,67.93,118,32.07
1514,15,14,330,223,67.58,107,32.42
1515,15,15,318,208,65.41,110,34.59
1516,15,16,419,298,71.12,121,28.88
1517,15,17,195,138,70.77,57,29.23
1518,15,18,138,91,65.94,47,34.06
1519,15,19,291,211,72.51,80,27.49
1520,15,20,211,150,71.09,61,28.91
1521,15,21,163,112,68.71,51,31.29
1522,15,22,192,135,70.31,57,29.69
1523,15,23,212,156,73.58,56,26.42
1524,15,24,184,119,64.67,65,35.33
1601,16,1,446,337,75.56,109,24.44
1602,16,2,252,170,67.46,82,32.54
1603,16,3,225,171,76.0,54,24.0
1604,16,4,299,197,65.89,102,34.11
1605,16,5,200,139,69.5,61,30.5
1606,16,6,235,168,71.49,67,28.51
1607,16,7,266,206,77.44,60,22.56
1608,16,8,195,153,78.46,42,21.54
1609,16,9,264,180,68.18,84,31.82
1610,16,10,219,155,70.78,64,29.22
1611,16,11,297,191,64.31,106,35.69
1612,16,12,261,184,70.5,77,29.5
1613,16,13,336,223,66.37,113,33.63
1614,16,14,200,143,71.5,57,28.5
1615,16,15,264,178,67.42,86,32.58
1616,16,16,206,147,71.36,59,28.64
1617,16,17,383,275,71.8,108,28.2
1618,16,18,322,237,73.6,85,26.4
1619,16,19,260,182,70.0,78,30.0
1620,16,20,170,116,68.24,54,31.76
1621,16,21,232,174,75.0,58,25.0
1622,16,22,226,169,74.78,57,25.22
1623,16,23,367,254,69.21,113,30.79
1624,16,24,130,98,75.38,32,24.62
1625,16,25,302,199,65.89,103,34.11
1626,16,26,169,125,73.96,44,26.04
1627,16,27,182,120,65.93,62,34.07
1628,16,28,196,147,75.0,49,25.0
1629,16,29,206,159,77.18,47,22.82
1630,16,30,187,131,70.05,56,29.95
1631,16,31,235,163,69.36,72,30.64
1632,16,32,379,271,71.5,108,28.5
1633,16,33,195,142,72.82,53,27.18
1634,16,34,224,163,72.77,61,27.23
1635,16,35,423,293,69.27,130,30.73
1636,16,36,174,122,70.11,52,29.89
1701,17,1,365,249,68.22,116,31.78
1702,17,2,294,202,68.71,92,31.29
1703,17,3,298,215,72.15,83,27.85
1704,17,4,334,243,72.75,91,27.25
1705,17,5,248,175,70.56,73,29.44
1706,17,6,335,253,75.52,82,24.48
1707,17,7,346,235,67.92,111,32.08
1708,17,8,217,154,70.97,63,29.03
1709,17,9,248,182,73.39,66,26.61
1710,17,10,389,294,75.58,95,24.42
1711,17,11,232,175,75.43,57,24.57
1712,17,12,486,339,69.75,147,30.25
1713,17,13,226,177,78.32,49,21.68
1714,17,14,371,269,72.51,102,27.49
1715,17,15,328,237,72.26,91,27.74
1716,17,16,390,289,74.1,101,25.9
1717,17,17,332,234,70.48,98,29.52
1718,17,18,370,287,77.57,83,22.43
1719,17,19,189,131,69.31,58,30.69
1720,17,20,396,332,83.84,64,16.16
1721,17,21,369,272,73.71,97,26.29
1722,17,22,304,226,74.34,78,25.66
1723,17,23,213,157,73.71,56,26.29
1724,17,24,249,188,75.5,61,24.5
1725,17,25,260,187,71.92,73,28.08
1726,17,26,319,257,80.56,62,19.44
1727,17,27,190,150,78.95,40,21.05
1728,17,28,229,178,77.73,51,22.27
1729,17,29,290,216,74.48,74,25.52
1730,17,30,327,234,71.56,93,28.44
1731,17,31,200,150,75.0,50,25.0
1732,17,32,242,179,73.97,63,26.03
1733,17,33,188,136,72.34,52,27.66
1734,17,34,232,183,78.88,49,21.12
1735,17,35,215,167,77.67,48,22.33
1736,17,36,230,164,71.3,66,28.7
1737,17,37,253,185,73.12,68,26.88
1738,17,38,345,249,72.17,96,27.83
1739,17,39,292,218,74.66,74,25.34
1740,17,40,356,269,75.56,87,24.44
1741,17,41,419,299,71.36,120,28.64
1801,18,1,364,248,68.13,116,31.87
1802,18,2,435,323,74.25,112,25.75
1803,18,3,312,223,71.47,89,28.53
1804,18,4,382,298,78.01,84,21.99
1805,18,5,227,161,70.93,66,29.07
1806,18,6,334,221,66.17,113,33.83
1807,18,7,367,268,73.02,99,26.98
1808,18,8,375,279,74.4,96,25.6
1809,18,9,342,252,73.68,90,26.32
1810,18,10,465,349,75.05,116,24.95
1811,18,11,352,261,74.15,91,25.85
1812,18,12,350,256,73.14,94,26.86
1813,18,13,395,297,75.19,98,24.81
1814,18,14,380,293,77.11,87,22.89
1815,18,15,398,286,71.86,112,28.14
1816,18,16,355,259,72.96,96,27.04
1817,18,17,394,283,71.83,111,28.17
1818,18,18,273,206,75.46,67,24.54
1819,18,19,306,239,78.1,67,21.9
1820,18,20,253,193,76.28,60,23.72
1821,18,21,457,343,75.05,114,24.95
1822,18,22,385,303,78.7,82,21.3
1823,18,23,365,259,70.96,106,29.04
1824,18,24,352,240,68.18,112,31.82
1825,18,25,390,272,69.74,118,30.26
1826,18,26,453,363,80.13,90,19.87
1827,18,27,323,245,75.85,78,24.15
1828,18,28,320,230,71.88,90,28.13
1829,18,29,434,312,71.89,122,28.11
1830,18,30,456,300,65.79,156,34.21
1831,18,31,399,291,72.93,108,27.07
1832,18,32,358,272,75.98,86,24.02
1833,18,33,275,214,77.82,61,22.18
1834,18,34,402,309,76.87,93,23.13
1835,18,35,429,329,76.69,100,23.31
1836,18,36,400,291,72.75,109,27.25
1837,18,37,415,317,76.39,98,23.61
1838,18,38,327,237,72.48,90,27.52
1839,18,39,311,224,72.03,87,27.97
1840,18,40,395,302,76.46,93,23.54
1841,18,41,440,323,73.41,117,26.59
1842,18,42,327,229,70.03,98,29.97
1843,18,43,334,236,70.66,98,29.34
1844,18,44,338,226,66.86,112,33.14
1845,18,45,387,289,74.68,98,25.32
1846,18,46,440,287,65.23,153,34.77
1847,18,47,293,208,70.99,85,29.01
1848,18,48,281,208,74.02,73,25.98
1849,18,49,239,167,69.87,72,30.13
1850,18,50,253,180,71.15,73,28.85
1901,19,1,329,219,66.57,110,33.43
1902,19,2,505,386,76.44,119,23.56
1903,19,3,300,160,53.33,140,46.67
1904,19,4,440,234,53.18,206,46.82
1905,19,5,422,332,78.67,90,21.33
1906,19,6,411,234,56.93,177,43.07
1907,19,7,325,225,69.23,100,30.77
1908,19,8,408,232,56.86,176,43.14
1909,19,9,268,172,64.18,96,35.82
1910,19,10,489,378,77.3,111,22.7
1911,19,11,351,183,52.14,168,47.86
1912,19,12,299,161,53.85,138,46.15
1913,19,13,479,357,74.53,122,25.47
1914,19,14,407,314,77.15,93,22.85
1915,19,15,518,305,58.88,213,41.12
1916,19,16,369,197,53.39,172,46.61
1917,19,17,336,231,68.75,105,31.25
1918,19,18,377,316,83.82,61,16.18
1919,19,19,483,392,81.16,91,18.84
1920,19,20,325,264,81.23,61,18.77
1921,19,21,400,220,55.0,180,45.0
1922,19,22,413,320,77.48,93,22.52
1923,19,23,384,274,71.35,110,28.65
1924,19,24,291,173,59.45,118,40.55
1925,19,25,375,292,77.87,83,22.13
1926,19,26,363,288,79.34,75,20.66
1927,19,27,405,305,75.31,100,24.69
1928,19,28,466,352,75.54,114,24.46
1929,19,29,399,226,56.64,173,43.36
1930,19,30,380,226,59.47,154,40.53
1931,19,31,342,267,78.07,75,21.93
1932,19,32,353,223,63.17,130,36.83
1933,19,33,423,261,61.7,162,38.3
1934,19,34,339,271,79.94,68,20.06
1935,19,35,352,287,81.53,65,18.47
1936,19,36,547,408,74.59,139,25.41
1937,19,37,402,323,80.35,79,19.65
1938,19,38,362,271,74.86,91,25.14
1939,19,39,199,142,71.36,57,28.64
1940,19,40,421,317,75.3,104,24.7
1941,19,41,361,205,56.79,156,43.21
1942,19,42,311,236,75.88,75,24.12
1943,19,43,546,410,75.09,136,24.91
1944,19,44,432,244,56.48,188,43.52
1945,19,45,416,271,65.14,145,34.86
1946,19,46,360,260,72.22,100,27.78
1947,19,47,581,436,75.04,145,24.96
1948,19,48,464,338,72.84,126,27.16
1949,19,49,494,397,80.36,97,19.64
1950,19,50,344,227,65.99,117,34.01
1951,19,51,416,289,69.47,127,30.53
1952,19,52,480,271,56.46,209,43.54
1953,19,53,353,255,72.24,98,27.76
1954,19,54,299,155,51.84,144,48.16
1955,19,55,322,191,59.32,131,40.68
1956,19,56,418,340,81.34,78,18.66
1957,19,57,334,269,80.54,65,19.46
2001,20,1,390,307,78.72,83,21.28
2002,20,2,121,76,62.81,45,37.19
2003,20,3,348,254,72.99,94,27.01
2004,20,4,158,107,67.72,51,32.28
2005,20,5,402,286,71.14,116,28.86
2006,20,6,154,97,62.99,57,37.01
2007,20,7,427,311,72.83,116,27.17
2008,20,8,312,237,75.96,75,24.04
2009,20,9,501,382,76.25,119,23.75
2010,20,10,235,171,72.77,64,27.23
2011,20,11,463,317,68.47,146,31.53
2012,20,12,347,237,68.3,110,31.7
2013,20,13,307,214,69.71,93,30.29
2014,20,14,187,143,76.47,44,23.53
2015,20,15,361,259,71.75,102,28.25
2016,20,16,432,323,74.77,109,25.23
2017,20,17,240,158,65.83,82,34.17
2018,20,18,238,174,73.11,64,26.89
2019,20,19,377,275,72.94,102,27.06
2020,20,20,276,199,72.1,77,27.9
2021,20,21,289,194,67.13,95,32.87
2022,20,22,489,366,74.85,123,25.15
2023,20,23,208,162,77.88,46,22.12
2024,20,24,443,344,77.65,99,22.35
2025,20,25,226,151,66.81,75,33.19
2026,20,26,335,262,78.21,73,21.79
2027,20,27,177,139,78.53,38,21.47
2028,20,28,223,158,70.85,65,29.15
2029,20,29,237,169,71.31,68,28.69
2030,20,30,160,126,78.75,34,21.25
2031,20,31,400,288,72.0,112,28.0
2032,20,32,266,185,69.55,81,30.45
2033,20,33,225,170,75.56,55,24.44
2034,20,34,439,367,83.6,72,16.4
2035,20,35,264,180,68.18,84,31.82
2036,20,36,113,85,75.22,28,24.78
2037,20,37,115,77,66.96,38,33.04
2038,20,38,100,69,69.0,31,31.0
2039,20,39,28,19,67.86,9,32.14
2101,21,1,391,310,79.28,81,20.72
2102,21,2,240,163,67.92,77,32.08
2103,21,3,350,262,74.86,88,25.14
2104,21,4,297,230,77.44,67,22.56
2105,21,5,357,259,72.55,98,27.45
2106,21,6,291,222,76.29,69,23.71
2107,21,7,339,277,81.71,62,18.29
2108,21,8,362,274,75.69,88,24.31
2109,21,9,361,276,76.45,85,23.55
2110,21,10,290,216,74.48,74,25.52
2111,21,11,306,225,73.53,81,26.47
2112,21,12,306,226,73.86,80,26.14
2113,21,13,378,279,73.81,99,26.19
2114,21,14,391,305,78.01,86,21.99
2115,21,15,324,243,75.0,81,25.0
2116,21,16,305,213,69.84,92,30.16
2117,21,17,285,209,73.33,76,26.67
2118,21,18,315,233,73.97,82,26.03
2119,21,19,410,308,75.12,102,24.88
2120,21,20,307,242,78.83,65,21.17
2121,21,21,309,220,71.2,89,28.8
2122,21,22,310,233,75.16,77,24.84
2123,21,23,323,254,78.64,69,21.36
2124,21,24,371,287,77.36,84,22.64
2125,21,25,301,224,74.42,77,25.58
2126,21,26,363,255,70.25,108,29.75
2127,21,27,413,321,77.72,92,22.28
2128,21,28,425,303,71.29,122,28.71
2129,21,29,381,296,77.69,85,22.31
2130,21,30,295,213,72.2,82,27.8
2131,21,31,194,160,82.47,34,17.53
2132,21,32,258,188,72.87,70,27.13
2133,21,33,285,216,75.79,69,24.21
2134,21,34,330,237,71.82,93,28.18
2135,21,35,412,310,75.24,102,24.76
2136,21,36,340,245,72.06,95,27.94
2137,21,37,245,180,73.47,65,26.53
2138,21,38,350,246,70.29,104,29.71
2139,21,39,341,238,69.79,103,30.21
2140,21,40,319,231,72.41,88,27.59
2141,21,41,369,261,70.73,108,29.27
2142,21,42,375,274,73.07,101,26.93
2143,21,43,347,254,73.2,93,26.8
2144,21,44,366,255,69.67,111,30.33
2145,21,45,326,229,70.25,97,29.75
2146,21,46,362,275,75.97,87,24.03
2147,21,47,327,241,73.7,86,26.3
2148,21,48,355,266,74.93,89,25.07
2149,21,49,388,293,75.52,95,24.48
2150,21,50,267,191,71.54,76,28.46
2151,21,51,368,278,75.54,90,24.46
2152,21,52,337,236,70.03,101,29.97
2153,21,53,304,226,74.34,78,25.66
2154,21,54,268,197,73.51,71,26.49
2201,22,1,193,147,76.17,46,23.83
2202,22,2,437,299,68.42,138,31.58
2203,22,3,548,379,69.16,169,30.84
2204,22,4,301,211,70.1,90,29.9
2205,22,5,331,226,68.28,105,31.72
2206,22,6,327,234,71.56,93,28.44
2207,22,7,294,222,75.51,72,24.49
2208,22,8,494,375,75.91,119,24.09
2209,22,9,291,223,76.63,68,23.37
2210,22,10,458,330,72.05,128,27.95
2211,22,11,248,170,68.55,78,31.45
2212,22,12,277,186,67.15,91,32.85
2213,22,13,370,271,73.24,99,26.76
2214,22,14,286,202,70.63,84,29.37
2215,22,15,305,191,62.62,114,37.38
2216,22,16,293,206,70.31,87,29.69
2217,22,17,472,329,69.7,143,30.3
2218,22,18,330,223,67.58,107,32.42
2219,22,19,168,121,72.02,47,27.98
2220,22,20,384,262,68.23,122,31.77
2221,22,21,320,231,72.19,89,27.81
2222,22,22,345,229,66.38,116,33.62
2223,22,23,354,267,75.42,87,24.58
2224,22,24,421,313,74.35,108,25.65
2225,22,25,342,263,76.9,79,23.1
2301,23,1,319,201,63.01,118,36.99
2302,23,2,362,242,66.85,120,33.15
2303,23,3,309,196,63.43,113,36.57
2304,23,4,320,219,68.44,101,31.56
2305,23,5,364,273,75.0,91,25.0
2306,23,6,348,251,72.13,97,27.87
2307,23,7,359,260,72.42,99,27.58
2308,23,8,436,294,67.43,142,32.57
2309,23,9,355,258,72.68,97,27.32
2310,23,10,418,303,72.49,115,27.51
2311,23,11,413,304,73.61,109,26.39
2312,23,12,359,228,63.51,131,36.49
2313,23,13,342,250,73.1,92,26.9
2314,23,14,299,188,62.88,111,37.12
2315,23,15,320,230,71.88,90,28.13
2316,23,16,340,225,66.18,115,33.82
2317,23,17,293,195,66.55,98,33.45
2318,23,18,320,203,63.44,117,36.56
2319,23,19,309,208,67.31,101,32.69
2320,23,20,258,179,69.38,79,30.62
2321,23,21,300,182,60.67,118,39.33
2322,23,22,335,238,71.04,97,28.96
2323,23,23,325,198,60.92,127,39.08
2324,23,24,323,218,67.49,105,32.51
2325,23,25,320,224,70.0,96,30.0
2326,23,26,358,268,74.86,90,25.14
2327,23,27,292,182,62.33,110,37.67
2328,23,28,384,245,63.8,139,36.2
2329,23,29,297,198,66.67,99,33.33
2330,23,30,442,307,69.46,135,30.54
2331,23,31,296,200,67.57,96,32.43
2332,23,32,355,235,66.2,120,33.8
2333,23,33,408,286,70.1,122,29.9
2334,23,34,395,282,71.39,113,28.61
2335,23,35,252,158,62.7,94,37.3
2336,23,36,340,228,67.06,112,32.94
2337,23,37,378,231,61.11,147,38.89
2338,23,38,315,206,65.4,109,34.6
2339,23,39,388,283,72.94,105,27.06
2401,24,1,240,168,70.0,72,30.0
2402,24,2,288,217,75.35,71,24.65
2403,24,3,346,251,72.54,95,27.46
2404,24,4,239,178,74.48,61,25.52
2405,24,5,164,119,72.56,45,27.44
2406,24,6,322,238,73.91,84,26.09
2407,24,7,226,174,76.99,52,23.01
2408,24,8,133,91,68.42,42,31.58
2409,24,9,267,186,69.66,81,30.34
2410,24,10,141,98,69.5,43,30.5
2411,24,11,292,198,67.81,94,32.19
2412,24,12,186,133,71.51,53,28.49
2413,24,13,183,113,61.75,70,38.25
2414,24,14,235,167,71.06,68,28.94
2415,24,15,152,115,75.66,37,24.34
2416,24,16,872,527,60.44,345,39.56
2417,24,17,209,142,67.94,67,32.06
2418,24,18,244,173,70.9,71,29.1
2419,24,19,321,228,71.03,93,28.97
2420,24,20,253,187,73.91,66,26.09
2421,24,21,157,104,66.24,53,33.76
2422,24,22,343,228,66.47,115,33.53
2423,24,23,259,177,68.34,82,31.66
2424,24,24,339,226,66.67,113,33.33
2425,24,25,205,151,73.66,54,26.34
2426,24,26,410,313,76.34,97,23.66
2427,24,27,309,227,73.46,82,26.54
2428,24,28,172,124,72.09,48,27.91
2429,24,29,204,141,69.12,63,30.88
2430,24,30,180,131,72.78,49,27.22
2431,24,31,294,189,64.29,105,35.71
2432,24,32,146,116,79.45,30,20.55
2433,24,33,173,119,68.79,54,31.21
2434,24,34,271,190,70.11,81,29.89
2435,24,35,261,184,70.5,77,29.5
2436,24,36,338,237,70.12,101,29.88
2437,24,37,136,92,67.65,44,32.35
2438,24,38,247,179,72.47,68,27.53
2439,24,39,271,202,74.54,69,25.46
2440,24,40,328,234,71.34,94,28.66
2441,24,41,126,91,72.22,35,27.78
2501,25,1,359,281,78.27,78,21.73
2502,25,2,539,397,73.65,142,26.35
2503,25,3,731,609,83.31,122,16.69
2504,25,4,343,254,74.05,89,25.95
2505,25,5,437,316,72.31,121,27.69
2506,25,6,138,109,78.99,29,21.01
2507,25,7,438,342,78.08,96,21.92
2508,25,8,521,376,72.17,145,27.83
2509,25,9,441,334,75.74,107,24.26
2510,25,10,588,514,87.41,74,12.59
2511,25,11,495,388,78.38,107,21.62
2512,25,12,441,356,80.73,85,19.27
2513,25,13,509,393,77.21,116,22.79
2514,25,14,287,248,86.41,39,13.59
2515,25,15,385,270,70.13,115,29.87
2516,25,16,700,585,83.57,115,16.43
2517,25,17,446,341,76.46,105,23.54
2518,25,18,221,179,81.0,42,19.0
2519,25,19,458,329,71.83,129,28.17
2520,25,20,249,145,58.23,104,41.77
2521,25,21,851,704,82.73,147,17.27
2522,25,22,464,341,73.49,123,26.51
2523,25,23,509,372,73.08,137,26.92
2524,25,24,462,336,72.73,126,27.27
2525,25,25,387,301,77.78,86,22.22
2526,25,26,463,338,73.0,125,27.0
2527,25,27,560,466,83.21,94,16.79
2528,25,28,483,373,77.23,110,22.77
2529,25,29,328,244,74.39,84,25.61
2530,25,30,439,321,73.12,118,26.88
2531,25,31,806,686,85.11,120,14.89
2532,25,32,365,242,66.3,123,33.7
2601,26,1,372,303,81.45,69,18.55
2602,26,2,274,214,78.1,60,21.9
2603,26,3,422,352,83.41,70,16.59
2604,26,4,245,166,67.76,79,32.24
2605,26,5,315,229,72.7,86,27.3
2606,26,6,299,217,72.58,82,27.42
2607,26,7,333,270,81.08,63,18.92
2608,26,8,220,140,63.64,80,36.36
2609,26,9,294,231,78.57,63,21.43
2610,26,10,349,263,75.36,86,24.64
2611,26,11,321,232,72.27,89,27.73
2612,26,12,348,280,80.46,68,19.54
2613,26,13,189,134,70.9,55,29.1
2614,26,14,279,215,77.06,64,22.94
2615,26,15,212,157,74.06,55,25.94
2616,26,16,185,134,72.43,51,27.57
2617,26,17,312,252,80.77,60,19.23
2618,26,18,256,192,75.0,64,25.0
2619,26,19,205,130,63.41,75,36.59
2620,26,20,296,239,80.74,57,19.26
2621,26,21,419,327,78.04,92,21.96
2622,26,22,184,136,73.91,48,26.09
2623,26,23,245,190,77.55,55,22.45
2624,26,24,274,205,74.82,69,25.18
2625,26,25,248,203,81.85,45,18.15
2626,26,26,249,180,72.29,69,27.71
2627,26,27,373,287,76.94,86,23.06
2628,26,28,445,359,80.67,86,19.33
2629,26,29,177,145,81.92,32,18.08
2630,26,30,272,224,82.35,48,17.65
2631,26,31,154,93,60.39,61,39.61
2632,26,32,404,318,78.71,86,21.29
2633,26,33,368,304,82.61,64,17.39
2634,26,34,354,281,79.38,73,20.62
2635,26,35,278,227,81.65,51,18.35
2636,26,36,331,259,78.25,72,21.75
2637,26,37,348,286,82.18,62,17.82
2638,26,38,168,112,66.67,56,33.33
2639,26,39,390,302,77.44,88,22.56
2640,26,40,198,142,71.72,56,28.28
2641,26,41,391,315,80.56,76,19.44
2642,26,42,273,216,79.12,57,20.88
2643,26,43,219,161,73.52,58,26.48
2644,26,44,178,131,73.6,47,26.4
2645,26,45,179,125,69.83,54,30.17
2646,26,46,248,190,76.61,58,23.39
2647,26,47,241,183,75.93,58,24.07
2648,26,48,357,281,78.71,76,21.29
2649,26,49,209,158,75.6,51,24.4
2701,27,1,892,760,85.2,132,14.8
2702,27,2,415,331,79.76,84,20.24
2703,27,3,174,138,79.31,36,20.69
2704,27,4,204,159,77.94,45,22.06
2705,27,5,299,206,68.9,93,31.1
2706,27,6,451,351,77.83,100,22.17
2707,27,7,570,476,83.51,94,16.49
2708,27,8,320,240,75.0,80,25.0
2709,27,9,181,143,79.01,38,20.99
2710,27,10,268,213,79.48,55,20.52
2711,27,11,449,380,84.63,69,15.37
2712,27,12,303,266,87.79,37,12.21
2713,27,13,531,420,79.1,111,20.9
2714,27,14,189,135,71.43,54,28.57
2715,27,15,185,128,69.19,57,30.81
2716,27,16,455,370,81.32,85,18.68
2717,27,17,399,298,74.69,101,25.31
2718,27,18,244,167,68.44,77,31.56
2719,27,19,180,133,73.89,47,26.11
2720,27,20,270,181,67.04,89,32.96
2721,27,21,356,290,81.46,66,18.54
2722,27,22,152,98,64.47,54,35.53
2723,27,23,219,152,69.41,67,30.59
2724,27,24,250,180,72.0,70,28.0
2725,27,25,345,260,75.36,85,24.64
2726,27,26,245,183,74.69,62,25.31
2727,27,27,501,379,75.65,122,24.35
2728,27,28,502,414,82.47,88,17.53
2729,27,29,254,176,69.29,78,30.71
2730,27,30,170,125,73.53,45,26.47
2731,27,31,274,183,66.79,91,33.21
2732,27,32,358,283,79.05,75,20.95
2733,27,33,543,444,81.77,99,18.23
2734,27,34,196,131,66.84,65,33.16
2735,27,35,517,431,83.37,86,16.63
2736,27,36,272,205,75.37,67,24.63
2737,27,37,341,275,80.65,66,19.35
2738,27,38,518,398,76.83,120,23.17
2739,27,39,257,184,71.6,73,28.4
2740,27,40,532,423,79.51,109,20.49
2741,27,41,259,192,74.13,67,25.87
2742,27,42,250,206,82.4,44,17.6
2743,27,43,310,240,77.42,70,22.58
2744,27,44,262,174,66.41,88,33.59
2745,27,45,1097,928,84.59,169,15.41
2746,27,46,337,293,86.94,44,13.06
2747,27,47,227,191,84.14,36,15.86
2748,27,48,682,530,77.71,152,22.29
2749,27,49,264,204,77.27,60,22.73
2750,27,50,310,223,71.94,87,28.06
2801,28,1,209,153,73.21,56,26.79
2802,28,2,250,185,74.0,65,26.0
2803,28,3,217,151,69.59,66,30.41
2804,28,4,283,231,81.63,52,18.37
2805,28,5,180,140,77.78,40,22.22
2806,28,6,168,142,84.52,26,15.48
2807,28,7,276,214,77.54,62,22.46
2808,28,8,481,398,82.74,83,17.26
2809,28,9,285,205,71.93,80,28.07
2810,28,10,375,292,77.87,83,22.13
2811,28,11,703,517,73.54,186,26.46
2812,28,12,259,199,76.83,60,23.17
2813,28,13,279,203,72.76,76,27.24
2814,28,14,272,193,70.96,79,29.04
2815,28,15,54,44,81.48,10,18.52
2816,28,16,182,129,70.88,53,29.12
2817,28,17,243,179,73.66,64,26.34
2818,28,18,240,161,67.08,79,32.92
2819,28,19,281,208,74.02,73,25.98
2820,28,20,232,176,75.86,56,24.14
2821,28,21,248,182,73.39,66,26.61
2822,28,22,256,195,76.17,61,23.83
2823,28,23,331,248,74.92,83,25.08
2824,28,24,251,166,66.14,85,33.86
2825,28,25,430,316,73.49,114,26.51
2826,28,26,250,177,70.8,73,29.2
2827,28,27,311,254,81.67,57,18.33
2828,28,28,390,317,81.28,73,18.72
2829,28,29,152,111,73.03,41,26.97
2830,28,30,46,38,82.61,8,17.39
2831,28,31,306,231,75.49,75,24.51
2832,28,32,274,188,68.61,86,31.39
2833,28,33,300,203,67.67,97,32.33
2834,28,34,508,353,69.49,155,30.51
2835,28,35,307,233,75.9,74,24.1
2836,28,36,129,100,77.52,29,22.48
2837,28,37,310,223,71.94,87,28.06
2838,28,38,117,90,76.92,27,23.08
2839,28,39,211,145,68.72,66,31.28
2840,28,40,356,273,76.69,83,23.31
2841,28,41,185,127,68.65,58,31.35
2842,28,42,288,212,73.61,76,26.39
2843,28,43,329,248,75.38,81,24.62
2844,28,44,217,143,65.9,74,34.1
2845,28,45,456,376,82.46,80,17.54
2846,28,46,583,454,77.87,129,22.13
2901,29,1,521,399,76.58,122,23.42
2902,29,2,437,311,71.17,126,28.83
2903,29,3,305,226,74.1,79,25.9
2904,29,4,432,328,75.93,104,24.07
2905,29,5,268,191,71.27,77,28.73
2906,29,6,261,190,72.8,71,27.2
2907,29,7,394,287,72.84,107,27.16
2908,29,8,352,252,71.59,100,28.41
2909,29,9,421,332,78.86,89,21.14
2910,29,10,482,368,76.35,114,23.65
2911,29,11,198,150,75.76,48,24.24
2912,29,12,457,351,76.81,106,23.19
2913,29,13,330,231,70.0,99,30.0
2914,29,14,320,254,79.38,66,20.63
2915,29,15,421,316,75.06,105,24.94
2916,29,16,346,265,76.59,81,23.41
2917,29,17,360,286,79.44,74,20.56
2918,29,18,327,238,72.78,89,27.22
2919,29,19,351,261,74.36,90,25.64
2920,29,20,382,283,74.08,99,25.92
2921,29,21,453,318,70.2,135,29.8
2922,29,22,269,201,74.72,68,25.28
2923,29,23,442,319,72.17,123,27.83
2924,29,24,355,273,76.9,82,23.1
2925,29,25,423,316,74.7,107,25.3
2926,29,26,339,280,82.6,59,17.4
2927,29,27,335,242,72.24,93,27.76
2928,29,28,421,310,73.63,111,26.37
2929,29,29,430,302,70.23,128,29.77
2930,29,30,513,385,75.05,128,24.95
2931,29,31,395,261,66.08,134,33.92
2932,29,32,408,283,69.36,125,30.64
2933,29,33,247,193,78.14,54,21.86
2934,29,34,257,182,70.82,75,29.18
2935,29,35,283,192,67.84,91,32.16
2936,29,36,330,247,74.85,83,25.15
2937,29,37,346,235,67.92,111,32.08
2938,29,38,472,344,72.88,128,27.12
2939,29,39,403,292,72.46,111,27.54
2940,29,40,404,300,74.26,104,25.74
2941,29,41,305,223,73.11,82,26.89
2942,29,42,389,288,74.04,101,25.96
2943,29,43,465,344,73.98,121,26.02
2944,29,44,389,285,73.26,104,26.74
3001,30,1,459,354,77.12,105,22.88
3002,30,2,409,288,70.42,121,29.58
3003,30,3,357,285,79.83,72,20.17
3004,30,4,407,311,76.41,96,23.59
3005,30,5,331,226,68.28,105,31.72
3006,30,6,288,210,72.92,78,27.08
3007,30,7,461,316,68.55,145,31.45
3008,30,8,511,387,75.73,124,24.27
3009,30,9,350,258,73.71,92,26.29
3010,30,10,390,285,73.08,105,26.92
3011,30,11,424,300,70.75,124,29.25
3012,30,12,373,267,71.58,106,28.42
3013,30,13,417,298,71.46,119,28.54
3014,30,14,306,208,67.97,98,32.03
3015,30,15,372,310,83.33,62,16.67
3016,30,16,223,156,69.96,67,30.04
3017,30,17,431,326,75.64,105,24.36
3018,30,18,527,431,81.78,96,18.22
3019,30,19,444,328,73.87,116,26.13
3020,30,20,436,324,74.31,112,25.69
3021,30,21,291,205,70.45,86,29.55
3022,30,22,622,487,78.3,135,21.7
3023,30,23,539,412,76.44,127,23.56
3024,30,24,602,459,76.25,143,23.75
3025,30,25,617,480,77.8,137,22.2
3026,30,26,264,200,75.76,64,24.24
3027,30,27,303,217,71.62,86,28.38
3028,30,28,441,340,77.1,101,22.9
3029,30,29,293,205,69.97,88,30.03
3030,30,30,180,125,69.44,55,30.56
3031,30,31,264,188,71.21,76,28.79
3032,30,32,345,270,78.26,75,21.74
3101,31,1,268,184,68.66,84,31.34
3102,31,2,258,183,70.93,75,29.07
3103,31,3,270,197,72.96,73,27.04
3104,31,4,361,279,77.29,82,22.71
3105,31,5,309,238,77.02,71,22.98
3106,31,6,194,143,73.71,51,26.29
3107,31,7,405,323,79.75,82,20.25
3108,31,8,270,195,72.22,75,27.78
3109,31,9,315,240,76.19,75,23.81
3110,31,10,336,262,77.98,74,22.02
3111,31,11,216,159,73.61,57,26.39
3112,31,12,236,167,70.76,69,29.24
3113,31,13,310,228,73.55,82,26.45
3114,31,14,269,203,75.46,66,24.54
3115,31,15,280,191,68.21,89,31.79
3116,31,16,348,282,81.03,66,18.97
3117,31,17,261,196,75.1,65,24.9
3118,31,18,269,189,70.26,80,29.74
3119,31,19,256,172,67.19,84,32.81
3120,31,20,247,160,64.78,87,35.22
3121,31,21,250,193,77.2,57,22.8
3122,31,22,246,180,73.17,66,26.83
3123,31,23,317,246,77.6,71,22.4
3124,31,24,290,219,75.52,71,24.48
3125,31,25,297,219,73.74,78,26.26
3126,31,26,286,209,73.08,77,26.92
3127,31,27,302,210,69.54,92,30.46
3128,31,28,275,204,74.18,71,25.82
3129,31,29,271,196,72.32,75,27.68
3130,31,30,239,173,72.38,66,27.62
3131,31,31,237,174,73.42,63,26.58
3132,31,32,230,173,75.22,57,24.78
3133,31,33,267,196,73.41,71,26.59
3134,31,34,286,198,69.23,88,30.77
3135,31,35,343,250,72.89,93,27.11
3136,31,36,278,209,75.18,69,24.82
3137,31,37,271,193,71.22,78,28.78
3138,31,38,256,194,75.78,62,24.22
3139,31,39,321,247,76.95,74,23.05
3140,31,40,321,224,69.78,97,30.22
3141,31,41,268,198,73.88,70,26.12
3201,32,1,646,510,78.95,136,21.05
3202,32,2,576,481,83.51,95,16.49
3203,32,3,547,454,83.0,93,17.0
3204,32,4,459,395,86.06,64,13.94
3205,32,5,541,469,86.69,72,13.31
3206,32,6,610,538,88.2,72,11.8
3207,32,7,589,503,85.4,86,14.6
3208,32,8,632,565,89.4,67,10.6
3209,32,9,516,415,80.43,101,19.57
3210,32,10,571,468,81.96,103,18.04
3211,32,11,457,379,82.93,78,17.07
3212,32,12,345,287,83.19,58,16.81
3213,32,13,563,462,82.06,101,17.94
3214,32,14,543,464,85.45,79,14.55
3215,32,15,484,399,82.44,85,17.56
3216,32,16,483,402,83.23,81,16.77
3217,32,17,498,413,82.93,85,17.07
3218,32,18,499,425,85.17,74,14.83
3219,32,19,477,400,83.86,77,16.14
3220,32,20,491,423,86.15,68,13.85
3221,32,21,520,452,86.92,68,13.08
3222,32,22,640,554,86.56,86,13.44
3223,32,23,540,474,87.78,66,12.22
3224,32,24,445,377,84.72,68,15.28
3225,32,25,506,428,84.58,78,15.42
3226,32,26,529,451,85.26,78,14.74
3227,32,27,520,428,82.31,92,17.69
3228,32,28,526,444,84.41,82,15.59
3229,32,29,538,458,85.13,80,14.87
3230,32,30,501,433,86.43,68,13.57
3231,32,31,545,458,84.04,87,15.96
3232,32,32,600,526,87.67,74,12.33
3233,32,33,458,405,88.43,53,11.57
3234,32,34,565,482,85.31,83,14.69
3235,32,35,484,408,84.3,76,15.7
3236,32,36,527,459,87.1,68,12.9
3237,32,37,598,490,81.94,108,18.06
3238,32,38,492,411,83.54,81,16.46
3239,32,39,578,490,84.78,88,15.22
3240,32,40,524,439,83.78,85,16.22
3241,32,41,535,441,82.43,94,17.57
3242,32,42,477,386,80.92,91,19.08
3243,32,43,465,384,82.58,81,17.42
3301,33,1,561,434,77.36,127,22.64
3302,33,2,699,551,78.83,148,21.17
3303,33,3,751,622,82.82,129,17.18
3304,33,4,710,557,78.45,153,21.55
3305,33,5,508,410,80.71,98,19.29
3306,33,6,485,377,77.73,108,22.27
3307,33,7,562,451,80.25,111,19.75
3308,33,8,664,566,85.24,98,14.76
3309,33,9,602,474,78.74,128,21.26
3310,33,10,452,366,80.97,86,19.03
3311,33,11,544,440,80.88,104,19.12
3312,33,12,551,445,80.76,106,19.24
3313,33,13,523,404,77.25,119,22.75
3314,33,14,259,205,79.15,54,20.85
3315,33,15,564,457,81.03,107,18.97
3316,33,16,728,557,76.51,171,23.49
3317,33,17,558,431,77.24,127,22.76
3318,33,18,764,626,81.94,138,18.06
3319,33,19,638,504,79.0,134,21.0
3320,33,20,682,567,83.14,115,16.86
3321,33,21,602,477,79.24,125,20.76
3322,33,22,502,381,75.9,121,24.1
3323,33,23,608,494,81.25,114,18.75
3324,33,24,672,589,87.65,83,12.35
3325,33,25,648,536,82.72,112,17.28
3326,33,26,397,321,80.86,76,19.14
3327,33,27,634,508,80.13,126,19.87
3328,33,28,504,410,81.35,94,18.65
3401,34,1,400,297,74.25,103,25.75
3402,34,2,318,255,80.19,63,19.81
3403,34,3,360,264,73.33,96,26.67
3404,34,4,274,214,78.1,60,21.9
3405,34,5,302,228,75.5,74,24.5
3406,34,6,400,301,75.25,99,24.75
3407,34,7,386,308,79.79,78,20.21
3408,34,8,312,235,75.32,77,24.68
3409,34,9,234,169,72.22,65,27.78
3410,34,10,308,244,79.22,64,20.78
3411,34,11,312,208,66.67,104,33.33
3412,34,12,376,296,78.72,80,21.28
3413,34,13,368,270,73.37,98,26.63
3414,34,14,272,208,76.47,64,23.53
3415,34,15,326,242,74.23,84,25.77
3416,34,16,330,243,73.64,87,26.36
3417,34,17,437,340,77.8,97,22.2
3418,34,18,216,152,70.37,64,29.63
3419,34,19,380,298,78.42,82,21.58
3420,34,20,408,318,77.94,90,22.06
3421,34,21,428,337,78.74,91,21.26
3422,34,22,361,277,76.73,84,23.27
3423,34,23,311,229,73.63,82,26.37
3424,34,24,307,230,74.92,77,25.08
3425,34,25,531,396,74.58,135,25.42
3426,34,26,423,318,75.18,105,24.82
3427,34,27,282,200,70.92,82,29.08
3428,34,28,229,169,73.8,60,26.2
3429,34,29,288,203,70.49,85,29.51
3430,34,30,342,278,81.29,64,18.71
3431,34,31,280,207,73.93,73,26.07
3432,34,32,351,265,75.5,86,24.5
3433,34,33,303,222,73.27,81,26.73
3434,34,34,412,330,80.1,82,19.9
3435,34,35,446,337,75.56,109,24.44
3436,34,36,311,244,78.46,67,21.54
3437,34,37,208,149,71.63,59,28.37
3438,34,38,184,134,72.83,50,27.17
3439,34,39,263,176,66.92,87,33.08
3440,34,40,382,283,74.08,99,25.92
3441,34,41,212,153,72.17,59,27.83
3442,34,42,358,275,76.82,83,23.18
3443,34,43,327,263,80.43,64,19.57
3444,34,44,307,237,77.2,70,22.8
3445,34,45,357,280,78.43,77,21.57
3446,34,46,242,188,77.69,54,22.31
3447,34,47,325,262,80.62,63,19.38
3448,34,48,364,297,81.59,67,18.41
3449,34,49,326,272,83.44,54,16.56
3450,34,50,285,231,81.05,54,18.95
3451,34,51,414,306,73.91,108,26.09
3452,34,52,283,218,77.03,65,22.97
3453,34,53,248,183,73.79,65,26.21
3501,35,1,458,352,76.86,106,23.14
3502,35,2,470,388,82.55,82,17.45
3503,35,3,423,321,75.89,102,24.11
3504,35,4,467,358,76.66,109,23.34
3505,35,5,392,308,78.57,84,21.43
3506,35,6,496,401,80.85,95,19.15
3507,35,7,471,389,82.59,82,17.41
3508,35,8,476,386,81.09,90,18.91
3509,35,9,406,301,74.14,105,25.86
3510,35,10,525,449,85.52,76,14.48
3511,35,11,522,414,79.31,108,20.69
3512,35,12,309,212,68.61,97,31.39
3513,35,13,326,254,77.91,72,22.09
3514,35,14,367,263,71.66,104,28.34
3515,35,15,561,466,83.07,95,16.93
3516,35,16,246,176,71.54,70,28.46
3517,35,17,457,371,81.18,86,18.82
3518,35,18,314,229,72.93,85,27.07
3519,35,19,286,214,74.83,72,25.17
3520,35,20,468,369,78.85,99,21.15
3521,35,21,468,359,76.71,109,23.29
3522,35,22,588,464,78.91,124,21.09
3523,35,23,467,355,76.02,112,23.98
3524,35,24,418,322,77.03,96,22.97
3525,35,25,475,390,82.11,85,17.89
3526,35,26,406,313,77.09,93,22.91
3527,35,27,413,340,82.32,73,17.68
3528,35,28,458,367,80.13,91,19.87
3529,35,29,440,334,75.91,106,24.09
3530,35,30,423,325,76.83,98,23.17
3531,35,31,495,387,78.18,108,21.82
3601,36,1,381,268,70.34,113,29.66
3602,36,2,371,265,71.43,106,28.57
3603,36,3,352,243,69.03,109,30.97
3604,36,4,434,314,72.35,120,27.65
3605,36,5,345,243,70.43,102,29.57
3606,36,6,341,241,70.67,100,29.33
3607,36,7,384,260,67.71,124,32.29
3608,36,8,320,227,70.94,93,29.06
3609,36,9,381,268,70.34,113,29.66
3610,36,10,494,368,74.49,126,25.51
3611,36,11,272,185,68.01,87,31.99
3612,36,12,237,167,70.46,70,29.54
3613,36,13,273,192,70.33,81,29.67
3614,36,14,425,314,73.88,111,26.12
3615,36,15,381,297,77.95,84,22.05
3616,36,16,380,291,76.58,89,23.42
3617,36,17,468,340,72.65,128,27.35
3618,36,18,405,278,68.64,127,31.36
3619,36,19,496,353,71.17,143,28.83
3620,36,20,436,314,72.02,122,27.98
3621,36,21,345,227,65.8,118,34.2
3622,36,22,358,236,65.92,122,34.08
3623,36,23,350,241,68.86,109,31.14
3624,36,24,453,309,68.21,144,31.79
3625,36,25,413,290,70.22,123,29.78
3626,36,26,355,249,70.14,106,29.86
3627,36,27,328,234,71.34,94,28.66
3628,36,28,347,243,70.03,104,29.97
3629,36,29,414,285,68.84,129,31.16
3630,36,30,366,249,68.03,117,31.97
3701,37,1,203,156,76.85,47,23.15
3702,37,2,301,213,70.76,88,29.24
3703,37,3,227,143,63.0,84,37.0
3704,37,4,264,168,63.64,96,36.36
3705,37,5,322,234,72.67,88,27.33
3706,37,6,221,161,72.85,60,27.15
3707,37,7,247,183,74.09,64,25.91
3708,37,8,224,159,70.98,65,29.02
3709,37,9,306,217,70.92,89,29.08
3710,37,10,400,299,74.75,101,25.25
3711,37,11,209,154,73.68,55,26.32
3712,37,12,301,219,72.76,82,27.24
3713,37,13,237,166,70.04,71,29.96
3714,37,14,366,260,71.04,106,28.96
3715,37,15,338,251,74.26,87,25.74
3716,37,16,352,246,69.89,106,30.11
3717,37,17,233,172,73.82,61,26.18
3718,37,18,273,196,71.79,77,28.21
3719,37,19,235,171,72.77,64,27.23
3720,37,20,281,217,77.22,64,22.78
3721,37,21,248,185,74.6,63,25.4
3722,37,22,283,199,70.32,84,29.68
3723,37,23,305,228,74.75,77,25.25
3724,37,24,300,216,72.0,84,28.0
3725,37,25,267,181,67.79,86,32.21
3726,37,26,431,310,71.93,121,28.07
3727,37,27,312,225,72.12,87,27.88
3728,37,28,270,193,71.48,77,28.52
3729,37,29,273,207,75.82,66,24.18
3730,37,30,279,195,69.89,84,30.11
3731,37,31,367,270,73.57,97,26.43
3732,37,32,285,216,75.79,69,24.21
3733,37,33,237,188,79.32,49,20.68
3734,37,34,275,199,72.36,76,27.64
3735,37,35,319,233,73.04,86,26.96
3736,37,36,222,168,75.68,54,24.32
3737,37,37,326,241,73.93,85,26.07
3738,37,38,336,241,71.73,95,28.27
3739,37,39,262,191,72.9,71,27.1
3740,37,40,328,241,73.48,87,26.52
3741,37,41,308,226,73.38,82,26.62
3801,38,1,378,290,76.72,88,23.28
3802,38,2,375,243,64.8,132,35.2
3803,38,3,400,274,68.5,126,31.5
3804,38,4,358,242,67.6,116,32.4
3805,38,5,368,253,68.75,115,31.25
3806,38,6,384,241,62.76,143,37.24
3807,38,7,369,250,67.75,119,32.25
3808,38,8,378,257,67.99,121,32.01
3809,38,9,461,315,68.33,146,31.67
3810,38,10,354,238,67.23,116,32.77
3811,38,11,357,277,77.59,80,22.41
3812,38,12,347,224,64.55,123,35.45
3813,38,13,442,317,71.72,125,28.28
3814,38,14,420,293,69.76,127,30.24
3815,38,15,364,266,73.08,98,26.92
3816,38,16,383,242,63.19,141,36.81
3817,38,17,462,300,64.94,162,35.06
3818,38,18,403,295,73.2,108,26.8
3819,38,19,424,308,72.64,116,27.36
3820,38,20,402,271,67.41,131,32.59
3821,38,21,391,284,72.63,107,27.37
3822,38,22,363,272,74.93,91,25.07
3823,38,23,412,300,72.82,112,27.18
3824,38,24,383,268,69.97,115,30.03
3825,38,25,366,269,73.5,97,26.5
3826,38,26,399,295,73.93,104,26.07
3827,38,27,379,254,67.02,125,32.98
3828,38,28,481,316,65.7,165,34.3
3829,38,29,408,282,69.12,126,30.88
3830,38,30,397,269,67.76,128,32.24
3831,38,31,411,320,77.86,91,22.14
3832,38,32,378,282,74.6,96,25.4
3833,38,33,335,244,72.84,91,27.16
3834,38,34,361,270,74.79,91,25.21
3835,38,35,379,277,73.09,102,26.91
3836,38,36,370,283,76.49,87,23.51
3837,38,37,378,249,65.87,129,34.13
3838,38,38,388,276,71.13,112,28.87
3839,38,39,422,304,72.04,118,27.96
3840,38,40,408,285,69.85,123,30.15
3841,38,41,352,279,79.26,73,20.74
3901,39,1,382,276,72.25,106,27.75
3902,39,2,255,214,83.92,41,16.08
3903,39,3,468,372,79.49,96,20.51
3904,39,4,393,274,69.72,119,30.28
3905,39,5,423,332,78.49,91,21.51
3906,39,6,445,326,73.26,119,26.74
3907,39,7,372,297,79.84,75,20.16
3908,39,8,426,330,77.46,96,22.54
3909,39,9,380,295,77.63,85,22.37
3910,39,10,195,169,86.67,26,13.33
3911,39,11,387,295,76.23,92,23.77
3912,39,12,562,428,76.16,134,23.84
3913,39,13,333,260,78.08,73,21.92
3914,39,14,419,313,74.7,106,25.3
3915,39,15,465,348,74.84,117,25.16
3916,39,16,377,284,75.33,93,24.67
3917,39,17,408,323,79.17,85,20.83
3918,39,18,416,340,81.73,76,18.27
3919,39,19,394,316,80.2,78,19.8
3920,39,20,515,368,71.46,147,28.54
3921,39,21,411,256,62.29,155,37.71
3922,39,22,409,326,79.71,83,20.29
3923,39,23,408,300,73.53,108,26.47
3924,39,24,505,346,68.51,159,31.49
3925,39,25,349,274,78.51,75,21.49
3926,39,26,366,267,72.95,99,27.05
3927,39,27,57,45,78.95,12,21.05
3928,39,28,522,415,79.5,107,20.5
3929,39,29,218,168,77.06,50,22.94
3930,39,30,514,424,82.49,90,17.51
3931,39,31,369,281,76.15,88,23.85
3932,39,32,307,224,72.96,83,27.04
3933,39,33,421,352,83.61,69,16.39
3934,39,34,485,359,74.02,126,25.98
3935,39,35,409,326,79.71,83,20.29
3936,39,36,100,83,83.0,17,17.0
3937,39,37,367,300,81.74,67,18.26
3938,39,38,208,165,79.33,43,20.67
3939,39,39,256,205,80.08,51,19.92
3940,39,40,409,294,71.88,115,28.12
3941,39,41,416,329,79.09,87,20.91
3942,39,42,418,323,77.27,95,22.73
3943,39,43,416,285,68.51,131,31.49
3944,39,44,315,234,74.29,81,25.71
3945,39,45,354,266,75.14,88,24.86
4001,40,1,410,322,78.54,88,21.46
4002,40,2,488,389,79.71,99,20.29
4003,40,3,601,492,81.86,109,18.14
4004,40,4,291,240,82.47,51,17.53
4005,40,5,529,445,84.12,84,15.88
4006,40,6,559,487,87.12,72,12.88
4007,40,7,455,399,87.69,56,12.31
4008,40,8,630,544,86.35,86,13.65
4009,40,9,368,294,79.89,74,20.11
4010,40,10,530,407,76.79,123,23.21
4011,40,11,492,414,84.15,78,15.85
4012,40,12,402,344,85.57,58,14.43
4013,40,13,707,620,87.69,87,12.31
4014,40,14,430,333,77.44,97,22.56
4015,40,15,454,364,80.18,90,19.82
4016,40,16,637,516,81.0,121,19.0
4017,40,17,389,322,82.78,67,17.22
4018,40,18,376,295,78.46,81,21.54
4019,40,19,579,434,74.96,145,25.04
4020,40,20,489,391,79.96,98,20.04
4021,40,21,541,470,86.88,71,13.12
4022,40,22,587,510,86.88,77,13.12
4023,40,23,587,513,87.39,74,12.61
4024,40,24,434,342,78.8,92,21.2
4025,40,25,562,472,83.99,90,16.01
4026,40,26,499,429,85.97,70,14.03
4027,40,27,579,478,82.56,101,17.44
4028,40,28,519,429,82.66,90,17.34
4029,40,29,487,377,77.41,110,22.59
4030,40,30,381,299,78.48,82,21.52
4031,40,31,540,476,88.15,64,11.85
4032,40,32,530,460,86.79,70,13.21
4033,40,33,475,412,86.74,63,13.26
4034,40,34,401,334,83.29,67,16.71
4035,40,35,324,263,81.17,61,18.83
4036,40,36,410,348,84.88,62,15.12
4037,40,37,505,420,83.17,85,16.83
4038,40,38,596,509,85.4,87,14.6
4039,40,39,193,144,74.61,49,25.39
4101,41,1,407,235,57.74,172,42.26
4102,41,2,449,280,62.36,169,37.64
4103,41,3,416,285,68.51,131,31.49
4104,41,4,409,290,70.9,119,29.1
4105,41,5,493,345,69.98,148,30.02
4106,41,6,482,361,74.9,121,25.1
4107,41,7,444,294,66.22,150,33.78
4108,41,8,428,272,63.55,156,36.45
4109,41,9,363,241,66.39,122,33.61
4110,41,10,418,296,70.81,122,29.19
4111,41,11,452,265,58.63,187,41.37
4112,41,12,455,315,69.23,140,30.77
4113,41,13,473,312,65.96,161,34.04
4114,41,14,441,317,71.88,124,28.12
4115,41,15,516,368,71.32,148,28.68
4116,41,16,403,267,66.25,136,33.75
4117,41,17,374,244,65.24,130,34.76
4118,41,18,378,258,68.25,120,31.75
4119,41,19,440,338,76.82,102,23.18
4120,41,20,315,214,67.94,101,32.06
4121,41,21,452,297,65.71,155,34.29
4122,41,22,489,310,63.39,179,36.61
4123,41,23,398,255,64.07,143,35.93
4124,41,24,405,250,61.73,155,38.27
4125,41,25,389,253,65.04,136,34.96
4126,41,26,393,261,66.41,132,33.59
4127,41,27,365,237,64.93,128,35.07
4128,41,28,406,270,66.5,136,33.5
4129,41,29,334,229,68.56,105,31.44
4130,41,30,372,258,69.35,114,30.65
4131,41,31,372,253,68.01,119,31.99
4132,41,32,371,253,68.19,118,31.81
4133,41,33,396,262,66.16,134,33.84
4134,41,34,384,242,63.02,142,36.98
4135,41,35,482,300,62.24,182,37.76
4136,41,36,435,277,63.68,158,36.32
4137,41,37,476,354,74.37,122,25.63
4138,41,38,415,273,65.78,142,34.22
4139,41,39,425,269,63.29,156,36.71
4140,41,40,458,268,58.52,190,41.48
4141,41,41,443,299,67.49,144,32.51
4142,41,42,417,278,66.67,139,33.33
4143,41,43,402,271,67.41,131,32.59
4144,41,44,430,263,61.16,167,38.84
4145,41,45,427,287,67.21,140,32.79
4146,41,46,415,280,67.47,135,32.53
4147,41,47,420,287,68.33,133,31.67
4201,42,1,417,364,87.29,53,12.71
4202,42,2,591,504,85.28,87,14.72
4203,42,3,515,443,86.02,72,13.98
4204,42,4,1135,959,84.49,176,15.51
4205,42,5,394,344,87.31,50,12.69
4206,42,6,455,378,83.08,77,16.92
4207,42,7,570,480,84.21,90,15.79
4208,42,8,381,299,78.48,82,21.52
4209,42,9,673,552,82.02,121,17.98
4210,42,10,706,577,81.73,129,18.27
4211,42,11,318,274,86.16,44,13.84
4212,42,12,396,344,86.87,52,13.13
4213,42,13,377,315,83.55,62,16.45
4214,42,14,677,572,84.49,105,15.51
4215,42,15,660,555,84.09,105,15.91
4216,42,16,500,416,83.2,84,16.8
4217,42,17,781,661,84.64,120,15.36
4218,42,18,651,552,84.79,99,15.21
4219,42,19,610,516,84.59,94,15.41
4220,42,20,591,484,81.9,107,18.1
4221,42,21,626,558,89.14,68,10.86
4222,42,22,277,233,84.12,44,15.88
4223,42,23,504,416,82.54,88,17.46
4224,42,24,441,376,85.26,65,14.74
4225,42,25,566,449,79.33,117,20.67
4226,42,26,780,652,83.59,128,16.41
4227,42,27,337,260,77.15,77,22.85
4228,42,28,537,440,81.94,97,18.06
4229,42,29,592,482,81.42,110,18.58
4230,42,30,371,316,85.18,55,14.82
4231,42,31,573,467,81.5,106,18.5
4232,42,32,600,487,81.17,113,18.83
4233,42,33,575,465,80.87,110,19.13
4234,42,34,387,320,82.69,67,17.31
4235,42,35,602,497,82.56,105,17.44
4236,42,36,893,726,81.3,167,18.7
4237,42,37,378,313,82.8,65,17.2
4238,42,38,494,405,81.98,89,18.02
4239,42,39,876,751,85.73,125,14.27
4240,42,40,734,616,83.92,118,16.08
4241,42,41,522,437,83.72,85,16.28
4242,42,42,885,771,87.12,114,12.88
4301,43,1,249,214,85.94,35,14.06
4302,43,2,526,456,86.69,70,13.31
4303,43,3,460,402,87.39,58,12.61
4304,43,4,556,476,85.61,80,14.39
4305,43,5,449,390,86.86,59,13.14
4306,43,6,384,329,85.68,55,14.32
4307,43,7,281,250,88.97,31,11.03
4308,43,8,372,324,87.1,48,12.9
4309,43,9,474,395,83.33,79,16.67
4310,43,10,586,512,87.37,74,12.63
4311,43,11,453,398,87.86,55,12.14
4312,43,12,312,274,87.82,38,12.18
4313,43,13,491,428,87.17,63,12.83
4314,43,14,496,423,85.28,73,14.72
4315,43,15,463,387,83.59,76,16.41
4316,43,16,647,556,85.94,91,14.06
4317,43,17,387,339,87.6,48,12.4
4318,43,18,534,460,86.14,74,13.86
4319,43,19,469,425,90.62,44,9.38
4320,43,20,588,508,86.39,80,13.61
4321,43,21,549,461,83.97,88,16.03
4322,43,22,332,289,87.05,43,12.95
4323,43,23,348,308,88.51,40,11.49
4324,43,24,356,300,84.27,56,15.73
4325,43,25,404,337,83.42,67,16.58
4326,43,26,291,251,86.25,40,13.75
4327,43,27,451,390,86.47,61,13.53
4328,43,28,588,504,85.71,84,14.29
4329,43,29,682,591,86.66,91,13.34
4330,43,30,511,442,86.5,69,13.5
4331,43,31,445,360,80.9,85,19.1
4332,43,32,495,451,91.11,44,8.89
4333,43,33,456,395,86.62,61,13.38
4334,43,34,315,271,86.03,44,13.97
4335,43,35,507,432,85.21,75,14.79
4336,43,36,323,273,84.52,50,15.48
4337,43,37,571,483,84.59,88,15.41
4338,43,38,329,272,82.67,57,17.33
4339,43,39,369,299,81.03,70,18.97
4340,43,40,367,312,85.01,55,14.99
4341,43,41,588,520,88.44,68,11.56
4342,43,42,454,393,86.56,61,13.44
4343,43,43,467,415,88.87,52,11.13
4344,43,44,456,398,87.28,58,12.72
4345,43,45,305,261,85.57,44,14.43
4346,43,46,296,249,84.12,47,15.88
4401,44,1,803,679,84.56,124,15.44
4402,44,2,524,451,86.07,73,13.93
4403,44,3,279,247,88.53,32,11.47
4404,44,4,397,359,90.43,38,9.57
4405,44,5,529,469,88.66,60,11.34
4406,44,6,658,580,88.15,78,11.85
4407,44,7,324,274,84.57,50,15.43
4408,44,8,722,633,87.67,89,12.33
4409,44,9,553,479,86.62,74,13.38
4410,44,10,569,478,84.01,91,15.99
4411,44,11,622,516,82.96,106,17.04
4412,44,12,555,481,86.67,74,13.33
4413,44,13,471,409,86.84,62,13.16
4414,44,14,530,448,84.53,82,15.47
4415,44,15,492,425,86.38,67,13.62
4416,44,16,630,530,84.13,100,15.87
4417,44,17,713,611,85.69,102,14.31
4418,44,18,579,495,85.49,84,14.51
4419,44,19,633,548,86.57,85,13.43
4420,44,20,675,592,87.7,83,12.3
4421,44,21,625,552,88.32,73,11.68
4422,44,22,512,438,85.55,74,14.45
4423,44,23,527,480,91.08,47,8.92
4424,44,24,355,324,91.27,31,8.73
4425,44,25,546,481,88.1,65,11.9
4426,44,26,707,612,86.56,95,13.44
4427,44,27,612,536,87.58,76,12.42
4428,44,28,589,500,84.89,89,15.11
4429,44,29,619,544,87.88,75,12.12
4430,44,30,650,574,88.31,76,11.69
4431,44,31,494,407,82.39,87,17.61
4432,44,32,627,515,82.14,112,17.86
4433,44,33,609,541,88.83,68,11.17
4434,44,34,554,495,89.35,59,10.65
4435,44,35,547,469,85.74,78,14.26
4436,44,36,632,556,87.97,76,12.03
4437,44,37,609,532,87.36,77,12.64
4438,44,38,650,539,82.92,111,17.08
4439,44,39,597,538,90.12,59,9.88
4440,44,40,509,447,87.82,62,12.18
4441,44,41,695,584,84.03,111,15.97
4501,45,1,363,290,79.89,73,20.11
4502,45,2,445,368,82.7,77,17.3
4503,45,3,394,328,83.25,66,16.75
4504,45,4,516,416,80.62,100,19.38
4505,45,5,451,360,79.82,91,20.18
4506,45,6,594,484,81.48,110,18.52
4507,45,7,615,511,83.09,104,16.91
4508,45,8,448,351,78.35,97,21.65
4509,45,9,433,311,71.82,122,28.18
4510,45,10,420,303,72.14,117,27.86
4511,45,11,343,255,74.34,88,25.66
4512,45,12,388,280,72.16,108,27.84
4513,45,13,348,269,77.3,79,22.7
4514,45,14,608,466,76.64,142,23.36
4515,45,15,521,406,77.93,115,22.07
4516,45,16,352,277,78.69,75,21.31
4517,45,17,458,334,72.93,124,27.07
4518,45,18,457,344,75.27,113,24.73
4519,45,19,237,180,75.95,57,24.05
4520,45,20,294,216,73.47,78,26.53
4521,45,21,364,261,71.7,103,28.3
4522,45,22,389,296,76.09,93,23.91
4523,45,23,392,279,71.17,113,28.83
4524,45,24,340,234,68.82,106,31.18
4525,45,25,279,186,66.67,93,33.33
4526,45,26,238,171,71.85,67,28.15
4527,45,27,406,282,69.46,124,30.54
4528,45,28,341,249,73.02,92,26.98
4529,45,29,269,205,76.21,64,23.79
4530,45,30,422,320,75.83,102,24.17
4531,45,31,335,258,77.01,77,22.99
4532,45,32,400,284,71.0,116,29.0
4533,45,33,300,236,78.67,64,21.33
4534,45,34,446,333,74.66,113,25.34
4535,45,35,464,348,75.0,116,25.0
4536,45,36,436,317,72.71,119,27.29
4537,45,37,402,282,70.15,120,29.85
4538,45,38,407,294,72.24,113,27.76
4539,45,39,419,315,75.18,104,24.82
4540,45,40,398,259,65.08,139,34.92
4541,45,41,375,252,67.2,123,32.8
4542,45,42,398,290,72.86,108,27.14
4543,45,43,445,316,71.01,129,28.99
4544,45,44,377,273,72.41,104,27.59
4545,45,45,265,173,65.28,92,34.72
4546,45,46,333,219,65.77,114,34.23
4547,45,47,302,201,66.56,101,33.44
4548,45,48,324,214,66.05,110,33.95
4601,46,1,399,326,81.7,73,18.3
4602,46,2,509,422,82.91,87,17.09
4603,46,3,590,523,88.64,67,11.36
4604,46,4,494,419,84.82,75,15.18
4605,46,5,684,570,83.33,114,16.67
4606,46,6,438,359,81.96,79,18.04
4607,46,7,477,404,84.7,73,15.3
4608,46,8,344,286,83.14,58,16.86
4609,46,9,576,487,84.55,89,15.45
4610,46,10,882,774,87.76,108,12.24
4611,46,11,486,397,81.69,89,18.31
4612,46,12,553,476,86.08,77,13.92
4613,46,13,537,464,86.41,73,13.59
4614,46,14,525,403,76.76,122,23.24
4615,46,15,524,461,87.98,63,12.02
4616,46,16,585,494,84.44,91,15.56
4617,46,17,546,458,83.88,88,16.12
4618,46,18,582,485,83.33,97,16.67
4619,46,19,334,285,85.33,49,14.67
4620,46,20,435,366,84.14,69,15.86
4621,46,21,399,314,78.7,85,21.3
4622,46,22,371,300,80.86,71,19.14
4623,46,23,484,399,82.44,85,17.56
4624,46,24,646,555,85.91,91,14.09
4625,46,25,511,440,86.11,71,13.89
4626,46,26,718,598,83.29,120,16.71
4627,46,27,678,566,83.48,112,16.52
4628,46,28,469,399,85.07,70,14.93
4629,46,29,408,350,85.78,58,14.22
4630,46,30,522,427,81.8,95,18.2
4631,46,31,527,471,89.37,56,10.63
4632,46,32,485,392,80.82,93,19.18
4633,46,33,520,455,87.5,65,12.5
4634,46,34,668,548,82.04,120,17.96
4635,46,35,586,491,83.79,95,16.21
4636,46,36,484,411,84.92,73,15.08
4637,46,37,413,344,83.29,69,16.71
4638,46,38,590,493,83.56,97,16.44
4639,46,39,471,380,80.68,91,19.32
4640,46,40,437,378,86.5,59,13.5
4701,47,1,373,313,83.91,60,16.09
4702,47,2,518,461,89.0,57,11.0
4703,47,3,493,431,87.42,62,12.58
4704,47,4,628,548,87.26,80,12.74
4705,47,5,580,490,84.48,90,15.52
4706,47,6,652,561,86.04,91,13.96
4707,47,7,500,401,80.2,99,19.8
4708,47,8,531,442,83.24,89,16.76
4709,47,9,498,424,85.14,74,14.86
4710,47,10,660,579,87.73,81,12.27
4711,47,11,539,457,84.79,82,15.21
4712,47,12,580,496,85.52,84,14.48
4713,47,13,527,450,85.39,77,14.61
4714,47,14,491,433,88.19,58,11.81
4715,47,15,675,576,85.33,99,14.67
4716,47,16,530,449,84.72,81,15.28
4717,47,17,525,416,79.24,109,20.76
4718,47,18,517,426,82.4,91,17.6
4719,47,19,843,740,87.78,103,12.22
4720,47,20,565,490,86.73,75,13.27
4721,47,21,516,427,82.75,89,17.25
4722,47,22,581,502,86.4,79,13.6
4723,47,23,609,546,89.66,63,10.34
4724,47,24,552,489,88.59,63,11.41
4725,47,25,650,556,85.54,94,14.46
4726,47,26,731,649,88.78,82,11.22
4727,47,27,458,397,86.68,61,13.32
4728,47,28,498,422,84.74,76,15.26
4729,47,29,636,557,87.58,79,12.42
4730,47,30,680,594,87.35,86,12.65
4731,47,31,585,498,85.13,87,14.87
4732,47,32,656,577,87.96,79,12.04
4733,47,33,517,441,85.3,76,14.7
4734,47,34,559,499,89.27,60,10.73
4735,47,35,528,433,82.01,95,17.99
4736,47,36,632,548,86.71,84,13.29
4737,47,37,502,436,86.85,66,13.15
4738,47,38,540,468,86.67,72,13.33
4739,47,39,533,460,86.3,73,13.7
4740,47,40,502,445,88.65,57,11.35
4741,47,41,592,506,85.47,86,14.53
4742,47,42,524,444,84.73,80,15.27
4743,47,43,485,422,87.01,63,12.99
4744,47,44,452,381,84.29,71,15.71
4745,47,45,515,440,85.44,75,14.56
4746,47,46,546,458,83.88,88,16.12
4747,47,47,657,570,86.76,87,13.24
4748,47,48,33,23,69.7,10,30.3
4801,48,1,504,432,85.71,72,14.29
4802,48,2,212,187,88.21,25,11.79
4803,48,3,578,472,81.66,106,18.34
4804,48,4,456,387,84.87,69,15.13
4805,48,5,253,225,88.93,28,11.07
4806,48,6,592,499,84.29,93,15.71
4807,48,7,535,478,89.35,57,10.65
4808,48,8,246,214,86.99,32,13.01
4809,48,9,320,265,82.81,55,17.19
4810,48,10,707,635,89.82,72,10.18
4811,48,11,405,362,89.38,43,10.62
4812,48,12,591,523,88.49,68,11.51
4813,48,13,616,515,83.6,101,16.4
4814,48,14,205,168,81.95,37,18.05
4815,48,15,322,265,82.3,57,17.7
4816,48,16,550,448,81.45,102,18.55
4817,48,17,424,377,88.92,47,11.08
4818,48,18,330,254,76.97,76,23.03
4819,48,19,348,305,87.64,43,12.36
4820,48,20,546,451,82.6,95,17.4
4821,48,21,643,503,78.23,140,21.77
4822,48,22,367,309,84.2,58,15.8
4823,48,23,436,383,87.84,53,12.16
4824,48,24,574,404,70.38,170,29.62
4825,48,25,433,388,89.61,45,10.39
4826,48,26,248,204,82.26,44,17.74
4827,48,27,493,407,82.56,86,17.44
4828,48,28,518,411,79.34,107,20.66
4829,48,29,177,161,90.96,16,9.04
4830,48,30,422,361,85.55,61,14.45
4831,48,31,726,587,80.85,139,19.15
4832,48,32,539,449,83.3,90,16.7
4833,48,33,260,232,89.23,28,10.77
4834,48,34,420,366,87.14,54,12.86
4835,48,35,288,232,80.56,56,19.44
4836,48,36,275,244,88.73,31,11.27
4837,48,37,514,441,85.8,73,14.2
4838,48,38,505,449,88.91,56,11.09
4839,48,39,368,303,82.34,65,17.66
4840,48,40,455,409,89.89,46,10.11
4841,48,41,656,545,83.08,111,16.92
4842,48,42,583,506,86.79,77,13.21
4843,48,43,588,494,84.01,94,15.99
4844,48,44,637,568,89.17,69,10.83
4845,48,45,378,330,87.3,48,12.7
4846,48,46,282,231,81.91,51,18.09
4901,49,1,336,236,70.24,100,29.76
4902,49,2,312,270,86.54,42,13.46
4903,49,3,634,518,81.7,116,18.3
4904,49,4,683,552,80.82,131,19.18
4905,49,5,491,412,83.91,79,16.09
4906,49,6,435,359,82.53,76,17.47
4907,49,7,401,333,83.04,68,16.96
4908,49,8,451,388,86.03,63,13.97
4909,49,9,514,426,82.88,88,17.12
4910,49,10,597,496,83.08,101,16.92
4911,49,11,664,563,84.79,101,15.21
4912,49,12,631,544,86.21,87,13.79
4913,49,13,581,465,80.03,116,19.97
4914,49,14,389,329,84.58,60,15.42
4915,49,15,379,304,80.21,75,19.79
4916,49,16,464,381,82.11,83,17.89
4917,49,17,387,314,81.14,73,18.86
4918,49,18,655,557,85.04,98,14.96
4919,49,19,475,380,80.0,95,20.0
4920,49,20,770,657,85.32,113,14.68
4921,49,21,314,257,81.85,57,18.15
4922,49,22,526,421,80.04,105,19.96
4923,49,23,677,565,83.46,112,16.54
4924,49,24,392,327,83.42,65,16.58
4925,49,25,646,518,80.19,128,19.81
4926,49,26,575,479,83.3,96,16.7
4927,49,27,589,484,82.17,105,17.83
4928,49,28,735,607,82.59,128,17.41
4929,49,29,591,494,83.59,97,16.41
4930,49,30,535,443,82.8,92,17.2
4931,49,31,352,276,78.41,76,21.59
4932,49,32,497,361,72.64,136,27.36
4933,49,33,398,329,82.66,69,17.34
5001,50,1,321,259,80.69,62,19.31
5002,50,2,216,175,81.02,41,18.98
5003,50,3,304,260,85.53,44,14.47
5004,50,4,411,346,84.18,65,15.82
5005,50,5,217,177,81.57,40,18.43
5006,50,6,403,329,81.64,74,18.36
5007,50,7,489,399,81.6,90,18.4
5008,50,8,372,291,78.23,81,21.77
5009,50,9,312,244,78.21,68,21.79
5010,50,10,376,284,75.53,92,24.47
5011,50,11,185,145,78.38,40,21.62
5012,50,12,147,117,79.59,30,20.41
5013,50,13,472,369,78.18,103,21.82
5014,50,14,118,95,80.51,23,19.49
5015,50,15,474,399,84.18,75,15.82
5016,50,16,107,84,78.5,23,21.5
5017,50,17,379,303,79.95,76,20.05
5018,50,18,49,41,83.67,8,16.33
5019,50,19,327,261,79.82,66,20.18
5020,50,20,421,336,79.81,85,20.19
5021,50,21,343,271,79.01,72,20.99
5022,50,22,333,263,78.98,70,21.02
5023,50,23,250,183,73.2,67,26.8
5024,50,24,221,158,71.49,63,28.51
5025,50,25,291,226,77.66,65,22.34
5026,50,26,406,316,77.83,90,22.17
5027,50,27,96,76,79.17,20,20.83
5028,50,28,421,340,80.76,81,19.24
5029,50,29,396,308,77.78,88,22.22
5030,50,30,319,262,82.13,57,17.87
5031,50,31,551,447,81.13,104,18.87
5032,50,32,442,353,79.86,89,20.14
5033,50,33,235,195,82.98,40,17.02
5034,50,34,460,374,81.3,86,18.7
5035,50,35,533,442,82.93,91,17.07
5036,50,36,397,323,81.36,74,18.64
5037,50,37,400,329,82.25,71,17.75
5038,50,38,123,98,79.67,25,20.33
5039,50,39,224,180,80.36,44,19.64
5040,50,40,254,201,79.13,53,20.87
