id,ward,precinct,total,Yes,Yes Percent,No,No Percent
0101,1,1,517,312,60.35,205,39.65
0102,1,2,466,290,62.23,176,37.77
0103,1,3,604,435,72.02,169,27.98
0104,1,4,578,405,70.07,173,29.93
0105,1,5,520,359,69.04,161,30.96
0106,1,6,440,316,71.82,124,28.18
0107,1,7,371,253,68.19,118,31.81
0108,1,8,418,283,67.7,135,32.3
0109,1,9,360,247,68.61,113,31.39
0110,1,10,626,436,69.65,190,30.35
0111,1,11,580,424,73.1,156,26.9
0112,1,12,610,363,59.51,247,40.49
0113,1,13,256,165,64.45,91,35.55
0114,1,14,456,316,69.3,140,30.7
0115,1,15,467,303,64.88,164,35.12
0116,1,16,563,363,64.48,200,35.52
0117,1,17,447,267,59.73,180,40.27
0118,1,18,511,299,58.51,212,41.49
0119,1,19,617,379,61.43,238,38.57
0120,1,20,411,272,66.18,139,33.82
0121,1,21,689,495,71.84,194,28.16
0122,1,22,344,227,65.99,117,34.01
0123,1,23,668,416,62.28,252,37.72
0124,1,24,469,278,59.28,191,40.72
0125,1,25,499,329,65.93,170,34.07
0126,1,26,342,220,64.33,122,35.67
0127,1,27,574,419,73.0,155,27.0
0128,1,28,167,118,70.66,49,29.34
0129,1,29,638,444,69.59,194,30.41
0130,1,30,586,343,58.53,243,41.47
0131,1,31,452,307,67.92,145,32.08
0132,1,32,496,337,67.94,159,32.06
0133,1,33,549,369,67.21,180,32.79
0134,1,34,420,294,70.0,126,30.0
0135,1,35,643,410,63.76,233,36.24
0136,1,36,582,416,71.48,166,28.52
0137,1,37,495,358,72.32,137,27.68
0138,1,38,491,335,68.23,156,31.77
0139,1,39,432,303,70.14,129,29.86
0140,1,40,435,327,75.17,108,24.83
0141,1,41,290,196,67.59,94,32.41
0142,1,42,176,115,65.34,61,34.66
0143,1,43,324,217,66.98,107,33.02
0144,1,44,470,285,60.64,185,39.36
0201,2,1,562,377,67.08,185,32.92
0202,2,2,341,263,77.13,78,22.87
0203,2,3,577,388,67.24,189,32.76
0204,2,4,506,321,63.44,185,36.56
0205,2,5,621,414,66.67,207,33.33
0206,2,6,541,361,66.73,180,33.27
0207,2,7,445,318,71.46,127,28.54
0208,2,8,625,432,69.12,193,30.88
0209,2,9,463,360,77.75,103,22.25
0210,2,10,333,265,79.58,68,20.42
0211,2,11,457,364,79.65,93,20.35
0212,2,12,372,303,81.45,69,18.55
0213,2,13,388,313,80.67,75,19.33
0214,2,14,507,333,65.68,174,34.32
0215,2,15,449,313,69.71,136,30.29
0216,2,16,500,346,69.2,154,30.8
0217,2,17,584,368,63.01,216,36.99
0218,2,18,425,342,80.47,83,19.53
0219,2,19,307,234,76.22,73,23.78
0220,2,20,591,450,76.14,141,23.86
0221,2,21,532,338,63.53,194,36.47
0222,2,22,466,369,79.18,97,20.82
0223,2,23,297,251,84.51,46,15.49
0224,2,24,414,329,79.47,85,20.53
0225,2,25,545,402,73.76,143,26.24
0226,2,26,382,282,73.82,100,26.18
0227,2,27,405,313,77.28,92,22.72
0228,2,28,532,414,77.82,118,22.18
0229,2,29,513,397,77.39,116,22.61
0230,2,30,413,331,80.15,82,19.85
0231,2,31,519,428,82.47,91,17.53
0232,2,32,424,334,78.77,90,21.23
0233,2,33,635,511,80.47,124,19.53
0234,2,34,324,267,82.41,57,17.59
0235,2,35,603,457,75.79,146,24.21
0236,2,36,478,362,75.73,116,24.27
0237,2,37,401,313,78.05,88,21.95
0238,2,38,401,315,78.55,86,21.45
0239,2,39,318,227,71.38,91,28.62
0240,2,40,651,513,78.8,138,21.2
0241,2,41,553,422,76.31,131,23.69
0242,2,42,523,420,80.31,103,19.69
0243,2,43,615,499,81.14,116,18.86
0244,2,44,284,220,77.46,64,22.54
0245,2,45,541,421,77.82,120,22.18
0246,2,46,251,179,71.31,72,28.69
0301,3,1,616,400,64.94,216,35.06
0302,3,2,447,327,73.15,120,26.85
0303,3,3,372,250,67.2,122,32.8
0304,3,4,527,352,66.79,175,33.21
0305,3,5,261,176,67.43,85,32.57
0306,3,6,653,478,73.2,175,26.8
0307,3,7,249,177,71.08,72,28.92
0308,3,8,349,213,61.03,136,38.97
0309,3,9,524,322,61.45,202,38.55
0310,3,10,205,138,67.32,67,32.68
0311,3,11,523,327,62.52,196,37.48
0312,3,12,414,284,68.6,130,31.4
0313,3,13,544,400,73.53,144,26.47
0314,3,14,528,382,72.35,146,27.65
0315,3,15,431,264,61.25,167,38.75
0316,3,16,386,240,62.18,146,37.82
0317,3,17,673,460,68.35,213,31.65
0318,3,18,601,407,67.72,194,32.28
0319,3,19,576,447,77.6,129,22.4
0320,3,20,487,289,59.34,198,40.66
0321,3,21,484,390,80.58,94,19.42
0322,3,22,671,478,71.24,193,28.76
0323,3,23,371,247,66.58,124,33.42
0324,3,24,401,280,69.83,121,30.17
0325,3,25,794,619,77.96,175,22.04
0326,3,26,517,399,77.18,118,22.82
0327,3,27,611,446,73.0,165,27.0
0328,3,28,219,147,67.12,72,32.88
0329,3,29,476,304,63.87,172,36.13
0330,3,30,386,251,65.03,135,34.97
0331,3,31,527,317,60.15,210,39.85
0332,3,32,758,556,73.35,202,26.65
0333,3,33,595,440,73.95,155,26.05
0334,3,34,705,502,71.21,203,28.79
0335,3,35,248,164,66.13,84,33.87
0336,3,36,217,134,61.75,83,38.25
0337,3,37,448,261,58.26,187,41.74
0338,3,38,327,243,74.31,84,25.69
0339,3,39,948,712,75.11,236,24.89
0340,3,40,486,345,70.99,141,29.01
0341,3,41,316,204,64.56,112,35.44
0401,4,1,703,447,63.58,256,36.42
0402,4,2,648,486,75.0,162,25.0
0403,4,3,383,244,63.71,139,36.29
0404,4,4,628,415,66.08,213,33.92
0405,4,5,506,327,64.62,179,35.38
0406,4,6,523,379,72.47,144,27.53
0407,4,7,623,439,70.47,184,29.53
0408,4,8,527,341,64.71,186,35.29
0409,4,9,513,367,71.54,146,28.46
0410,4,10,616,416,67.53,200,32.47
0411,4,11,473,316,66.81,157,33.19
0412,4,12,662,429,64.8,233,35.2
0413,4,13,643,481,74.81,162,25.19
0414,4,14,481,331,68.81,150,31.19
0415,4,15,554,370,66.79,184,33.21
0416,4,16,854,649,76.0,205,24.0
0417,4,17,578,426,73.7,152,26.3
0418,4,18,457,309,67.61,148,32.39
0419,4,19,316,181,57.28,135,42.72
0420,4,20,368,287,77.99,81,22.01
0421,4,21,549,389,70.86,160,29.14
0422,4,22,434,300,69.12,134,30.88
0423,4,23,602,406,67.44,196,32.56
0424,4,24,454,314,69.16,140,30.84
0425,4,25,605,457,75.54,148,24.46
0426,4,26,430,283,65.81,147,34.19
0427,4,27,653,411,62.94,242,37.06
0428,4,28,431,289,67.05,142,32.95
0429,4,29,466,299,64.16,167,35.84
0430,4,30,663,428,64.56,235,35.44
0431,4,31,410,302,73.66,108,26.34
0432,4,32,549,357,65.03,192,34.97
0433,4,33,452,299,66.15,153,33.85
0434,4,34,434,287,66.13,147,33.87
0435,4,35,576,393,68.23,183,31.77
0436,4,36,592,407,68.75,185,31.25
0437,4,37,935,710,75.94,225,24.06
0438,4,38,540,388,71.85,152,28.15
0501,5,1,420,255,60.71,165,39.29
0502,5,2,346,214,61.85,132,38.15
0503,5,3,454,308,67.84,146,32.16
0504,5,4,597,385,64.49,212,35.51
0505,5,5,391,251,64.19,140,35.81
0506,5,6,338,218,64.5,120,35.5
0507,5,7,419,294,70.17,125,29.83
0508,5,8,433,326,75.29,107,24.71
0509,5,9,518,373,72.01,145,27.99
0510,5,10,364,229,62.91,135,37.09
0511,5,11,443,298,67.27,145,32.73
0512,5,12,288,181,62.85,107,37.15
0513,5,13,399,254,63.66,145,36.34
0514,5,14,356,222,62.36,134,37.64
0515,5,15,423,292,69.03,131,30.97
0516,5,16,428,254,59.35,174,40.65
0517,5,17,358,228,63.69,130,36.31
0518,5,18,422,272,64.45,150,35.55
0519,5,19,424,285,67.22,139,32.78
0520,5,20,476,344,72.27,132,27.73
0521,5,21,452,320,70.8,132,29.2
0522,5,22,523,387,74.0,136,26.0
0523,5,23,770,527,68.44,243,31.56
0524,5,24,582,370,63.57,212,36.43
0525,5,25,383,273,71.28,110,28.72
0526,5,26,445,285,64.04,160,35.96
0527,5,27,410,286,69.76,124,30.24
0528,5,28,444,312,70.27,132,29.73
0529,5,29,464,299,64.44,165,35.56
0530,5,30,287,165,57.49,122,42.51
0531,5,31,340,216,63.53,124,36.47
0532,5,32,483,333,68.94,150,31.06
0533,5,33,405,257,63.46,148,36.54
0534,5,34,450,337,74.89,113,25.11
0535,5,35,552,404,73.19,148,26.81
0536,5,36,250,185,74.0,65,26.0
0537,5,37,469,345,73.56,124,26.44
0538,5,38,408,256,62.75,152,37.25
0539,5,39,364,274,75.27,90,24.73
0540,5,40,347,209,60.23,138,39.77
0541,5,41,187,149,79.68,38,20.32
0601,6,1,372,257,69.09,115,30.91
0602,6,2,372,260,69.89,112,30.11
0603,6,3,351,242,68.95,109,31.05
0604,6,4,260,147,56.54,113,43.46
0605,6,5,230,133,57.83,97,42.17
0606,6,6,434,273,62.9,161,37.1
0607,6,7,363,221,60.88,142,39.12
0608,6,8,356,240,67.42,116,32.58
0609,6,9,381,234,61.42,147,38.58
0610,6,10,243,156,64.2,87,35.8
0611,6,11,324,212,65.43,112,34.57
0612,6,12,271,176,64.94,95,35.06
0613,6,13,265,168,63.4,97,36.6
0614,6,14,334,216,64.67,118,35.33
0615,6,15,308,186,60.39,122,39.61
0616,6,16,381,241,63.25,140,36.75
0617,6,17,234,147,62.82,87,37.18
0618,6,18,261,192,73.56,69,26.44
0619,6,19,291,165,56.7,126,43.3
0620,6,20,235,160,68.09,75,31.91
0621,6,21,171,105,61.4,66,38.6
0622,6,22,213,145,68.08,68,31.92
0623,6,23,158,100,63.29,58,36.71
0624,6,24,191,123,64.4,68,35.6
0625,6,25,183,117,63.93,66,36.07
0626,6,26,252,166,65.87,86,34.13
0627,6,27,210,138,65.71,72,34.29
0628,6,28,168,101,60.12,67,39.88
0629,6,29,352,241,68.47,111,31.53
0630,6,30,313,208,66.45,105,33.55
0631,6,31,316,227,71.84,89,28.16
0632,6,32,374,251,67.11,123,32.89
0633,6,33,371,254,68.46,117,31.54
0634,6,34,362,230,63.54,132,36.46
0635,6,35,327,204,62.39,123,37.61
0636,6,36,386,255,66.06,131,33.94
0637,6,37,397,257,64.74,140,35.26
0638,6,38,397,256,64.48,141,35.52
0639,6,39,291,179,61.51,112,38.49
0640,6,40,313,208,66.45,105,33.55
0641,6,41,365,218,59.73,147,40.27
0642,6,42,329,211,64.13,118,35.87
0643,6,43,330,209,63.33,121,36.67
0644,6,44,380,235,61.84,145,38.16
0645,6,45,367,233,63.49,134,36.51
0646,6,46,278,164,58.99,114,41.01
0647,6,47,239,162,67.78,77,32.22
0648,6,48,347,229,65.99,118,34.01
0701,7,1,348,219,62.93,129,37.07
0702,7,2,332,207,62.35,125,37.65
0703,7,3,331,226,68.28,105,31.72
0704,7,4,337,236,70.03,101,29.97
0705,7,5,304,206,67.76,98,32.24
0706,7,6,434,272,62.67,162,37.33
0707,7,7,343,207,60.35,136,39.65
0708,7,8,208,128,61.54,80,38.46
0709,7,9,592,382,64.53,210,35.47
0710,7,10,342,239,69.88,103,30.12
0711,7,11,372,226,60.75,146,39.25
0712,7,12,315,205,65.08,110,34.92
0713,7,13,201,127,63.18,74,36.82
0714,7,14,392,247,63.01,145,36.99
0715,7,15,323,218,67.49,105,32.51
0716,7,16,341,208,61.0,133,39.0
0717,7,17,281,169,60.14,112,39.86
0718,7,18,309,190,61.49,119,38.51
0719,7,19,333,224,67.27,109,32.73
0720,7,20,277,162,58.48,115,41.52
0721,7,21,267,163,61.05,104,38.95
0722,7,22,299,187,62.54,112,37.46
0723,7,23,316,215,68.04,101,31.96
0724,7,24,280,190,67.86,90,32.14
0725,7,25,281,185,65.84,96,34.16
0726,7,26,261,156,59.77,105,40.23
0727,7,27,256,170,66.41,86,33.59
0728,7,28,252,156,61.9,96,38.1
0729,7,29,322,206,63.98,116,36.02
0730,7,30,275,207,75.27,68,24.73
0731,7,31,248,164,66.13,84,33.87
0732,7,32,432,287,66.44,145,33.56
0733,7,33,412,292,70.87,120,29.13
0734,7,34,429,282,65.73,147,34.27
0735,7,35,373,246,65.95,127,34.05
0736,7,36,441,288,65.31,153,34.69
0737,7,37,339,236,69.62,103,30.38
0738,7,38,311,207,66.56,104,33.44
0739,7,39,317,196,61.83,121,38.17
0740,7,40,272,186,68.38,86,31.62
0741,7,41,332,223,67.17,109,32.83
0742,7,42,342,226,66.08,116,33.92
0743,7,43,323,232,71.83,91,28.17
0744,7,44,302,204,67.55,98,32.45
0745,7,45,322,217,67.39,105,32.61
0746,7,46,81,58,71.6,23,28.4
0801,8,1,318,216,67.92,102,32.08
0802,8,2,335,214,63.88,121,36.12
0803,8,3,379,239,63.06,140,36.94
0804,8,4,404,287,71.04,117,28.96
0805,8,5,310,220,70.97,90,29.03
0806,8,6,345,222,64.35,123,35.65
0807,8,7,403,270,67.0,133,33.0
0808,8,8,358,242,67.6,116,32.4
0809,8,9,232,162,69.83,70,30.17
0810,8,10,448,310,69.2,138,30.8
0811,8,11,299,182,60.87,117,39.13
0812,8,12,313,201,64.22,112,35.78
0813,8,13,409,282,68.95,127,31.05
0814,8,14,287,159,55.4,128,44.6
0815,8,15,225,159,70.67,66,29.33
0816,8,16,104,67,64.42,37,35.58
0817,8,17,288,192,66.67,96,33.33
0818,8,18,314,204,64.97,110,35.03
0819,8,19,382,256,67.02,126,32.98
0820,8,20,414,244,58.94,170,41.06
0821,8,21,452,270,59.73,182,40.27
0822,8,22,320,213,66.56,107,33.44
0823,8,23,277,193,69.68,84,30.32
0824,8,24,186,118,63.44,68,36.56
0825,8,25,349,211,60.46,138,39.54
0826,8,26,292,175,59.93,117,40.07
0827,8,27,390,247,63.33,143,36.67
0828,8,28,366,253,69.13,113,30.87
0829,8,29,371,248,66.85,123,33.15
0830,8,30,388,271,69.85,117,30.15
0831,8,31,279,178,63.8,101,36.2
0832,8,32,279,190,68.1,89,31.9
0833,8,33,262,152,58.02,110,41.98
0834,8,34,321,235,73.21,86,26.79
0835,8,35,405,248,61.23,157,38.77
0836,8,36,351,222,63.25,129,36.75
0837,8,37,274,175,63.87,99,36.13
0838,8,38,262,194,74.05,68,25.95
0839,8,39,328,219,66.77,109,33.23
0840,8,40,282,189,67.02,93,32.98
0841,8,41,373,225,60.32,148,39.68
0842,8,42,458,308,67.25,150,32.75
0843,8,43,197,123,62.44,74,37.56
0844,8,44,244,173,70.9,71,29.1
0845,8,45,299,200,66.89,99,33.11
0846,8,46,284,188,66.2,96,33.8
0847,8,47,288,185,64.24,103,35.76
0848,8,48,313,195,62.3,118,37.7
0849,8,49,337,208,61.72,129,38.28
0850,8,50,328,217,66.16,111,33.84
0851,8,51,334,224,67.07,110,32.93
0852,8,52,438,298,68.04,140,31.96
0853,8,53,201,143,71.14,58,28.86
0854,8,54,294,174,59.18,120,40.82
0855,8,55,254,185,72.83,69,27.17
0856,8,56,366,228,62.3,138,37.7
0901,9,1,317,221,69.72,96,30.28
0902,9,2,278,178,64.03,100,35.97
0903,9,3,203,130,64.04,73,35.96
0904,9,4,247,163,65.99,84,34.01
0905,9,5,330,215,65.15,115,34.85
0906,9,6,315,204,64.76,111,35.24
0907,9,7,266,182,68.42,84,31.58
0908,9,8,346,206,59.54,140,40.46
0909,9,9,373,239,64.08,134,35.92
0910,9,10,245,153,62.45,92,37.55
0911,9,11,244,164,67.21,80,32.79
0912,9,12,365,247,67.67,118,32.33
0913,9,13,371,254,68.46,117,31.54
0914,9,14,381,259,67.98,122,32.02
0915,9,15,339,194,57.23,145,42.77
0916,9,16,336,194,57.74,142,42.26
0917,9,17,209,143,68.42,66,31.58
0918,9,18,235,152,64.68,83,35.32
0919,9,19,345,226,65.51,119,34.49
0920,9,20,307,200,65.15,107,34.85
0921,9,21,303,190,62.71,113,37.29
0922,9,22,365,251,68.77,114,31.23
0923,9,23,360,224,62.22,136,37.78
0924,9,24,338,218,64.5,120,35.5
0925,9,25,287,200,69.69,87,30.31
0926,9,26,295,182,61.69,113,38.31
0927,9,27,265,186,70.19,79,29.81
0928,9,28,222,155,69.82,67,30.18
0929,9,29,286,174,60.84,112,39.16
0930,9,30,280,185,66.07,95,33.93
0931,9,31,281,191,67.97,90,32.03
0932,9,32,336,206,61.31,130,38.69
0933,9,33,235,160,68.09,75,31.91
0934,9,34,277,184,66.43,93,33.57
0935,9,35,310,224,72.26,86,27.74
0936,9,36,291,187,64.26,104,35.74
0937,9,37,512,316,61.72,196,38.28
0938,9,38,312,195,62.5,117,37.5
0939,9,39,348,233,66.95,115,33.05
0940,9,40,367,259,70.57,108,29.43
0941,9,41,267,178,66.67,89,33.33
0942,9,42,351,226,64.39,125,35.61
0943,9,43,287,191,66.55,96,33.45
0944,9,44,309,202,65.37,107,34.63
0945,9,45,247,144,58.3,103,41.7
0946,9,46,319,217,68.03,102,31.97
0947,9,47,351,242,68.95,109,31.05
0948,9,48,329,215,65.35,114,34.65
0949,9,49,357,243,68.07,114,31.93
0950,9,50,449,274,61.02,175,38.98
0951,9,51,333,224,67.27,109,32.73
1001,10,1,275,199,72.36,76,27.64
1002,10,2,338,229,67.75,109,32.25
1003,10,3,372,243,65.32,129,34.68
1004,10,4,271,169,62.36,102,37.64
1005,10,5,286,214,74.83,72,25.17
1006,10,6,289,223,77.16,66,22.84
1007,10,7,271,201,74.17,70,25.83
1008,10,8,187,104,55.61,83,44.39
1009,10,9,342,240,70.18,102,29.82
1010,10,10,407,271,66.58,136,33.42
1011,10,11,468,332,70.94,136,29.06
1012,10,12,261,182,69.73,79,30.27
1013,10,13,325,232,71.38,93,28.62
1014,10,14,461,327,70.93,134,29.07
1015,10,15,616,410,66.56,206,33.44
1016,10,16,310,207,66.77,103,33.23
1017,10,17,474,312,65.82,162,34.18
1018,10,18,207,141,68.12,66,31.88
1019,10,19,376,265,70.48,111,29.52
1020,10,20,368,267,72.55,101,27.45
1021,10,21,361,261,72.3,100,27.7
1022,10,22,218,164,75.23,54,24.77
1023,10,23,310,227,73.23,83,26.77
1024,10,24,330,234,70.91,96,29.09
1025,10,25,108,75,69.44,33,30.56
1026,10,26,262,199,75.95,63,24.05
1027,10,27,299,202,67.56,97,32.44
1028,10,28,407,297,72.97,110,27.03
1029,10,29,379,264,69.66,115,30.34
1030,10,30,326,219,67.18,107,32.82
1031,10,31,322,237,73.6,85,26.4
1032,10,32,374,259,69.25,115,30.75
1033,10,33,291,206,70.79,85,29.21
1034,10,34,240,148,61.67,92,38.33
1035,10,35,383,258,67.36,125,32.64
1036,10,36,86,62,72.09,24,27.91
1101,11,1,378,240,63.49,138,36.51
1102,11,2,32,18,56.25,14,43.75
1103,11,3,432,239,55.32,193,44.68
1104,11,4,296,195,65.88,101,34.12
1105,11,5,567,329,58.02,238,41.98
1106,11,6,663,460,69.38,203,30.62
1107,11,7,401,281,70.07,120,29.93
1108,11,8,397,270,68.01,127,31.99
1109,11,9,375,235,62.67,140,37.33
1110,11,10,407,289,71.01,118,28.99
1111,11,11,470,315,67.02,155,32.98
1112,11,12,520,388,74.62,132,25.38
1113,11,13,478,331,69.25,147,30.75
1114,11,14,202,137,67.82,65,32.18
1115,11,15,155,106,68.39,49,31.61
1116,11,16,283,206,72.79,77,27.21
1117,11,17,522,336,64.37,186,35.63
1118,11,18,321,227,70.72,94,29.28
1119,11,19,576,349,60.59,227,39.41
1120,11,20,285,196,68.77,89,31.23
1121,11,21,494,347,70.24,147,29.76
1122,11,22,539,330,61.22,209,38.78
1123,11,23,211,154,72.99,57,27.01
1124,11,24,480,351,73.13,129,26.88
1125,11,25,512,349,68.16,163,31.84
1126,11,26,434,296,68.2,138,31.8
1127,11,27,169,119,70.41,50,29.59
1128,11,28,193,133,68.91,60,31.09
1129,11,29,504,365,72.42,139,27.58
1130,11,30,215,146,67.91,69,32.09
1131,11,31,378,254,67.2,124,32.8
1132,11,32,172,118,68.6,54,31.4
1133,11,33,536,410,76.49,126,23.51
1134,11,34,119,75,63.03,44,36.97
1135,11,35,64,43,67.19,21,32.81
1136,11,36,183,128,69.95,55,30.05
1137,11,37,111,67,60.36,44,39.64
1138,11,38,223,137,61.43,86,38.57
1201,12,1,367,234,63.76,133,36.24
1202,12,2,301,221,73.42,80,26.58
1203,12,3,462,278,60.17,184,39.83
1204,12,4,446,286,64.13,160,35.87
1205,12,5,318,207,65.09,111,34.91
1206,12,6,422,288,68.25,134,31.75
1207,12,7,355,232,65.35,123,34.65
1208,12,8,373,251,67.29,122,32.71
1209,12,9,312,221,70.83,91,29.17
1210,12,10,513,311,60.62,202,39.38
1211,12,11,407,263,64.62,144,35.38
1212,12,12,370,258,69.73,112,30.27
1213,12,13,410,294,71.71,116,28.29
1214,12,14,333,213,63.96,120,36.04
1215,12,15,337,228,67.66,109,32.34
1216,12,16,331,219,66.16,112,33.84
1217,12,17,450,297,66.0,153,34.0
1218,12,18,365,219,60.0,146,40.0
1219,12,19,366,249,68.03,117,31.97
1220,12,20,475,331,69.68,144,30.32
1221,12,21,405,276,68.15,129,31.85
1222,12,22,382,232,60.73,150,39.27
1223,12,23,389,265,68.12,124,31.88
1301,13,1,314,226,71.97,88,28.03
1302,13,2,254,182,71.65,72,28.35
1303,13,3,288,208,72.22,80,27.78
1304,13,4,371,240,64.69,131,35.31
1305,13,5,416,305,73.32,111,26.68
1306,13,6,284,198,69.72,86,30.28
1307,13,7,294,212,72.11,82,27.89
1308,13,8,268,194,72.39,74,27.61
1309,13,9,387,282,72.87,105,27.13
1310,13,10,279,174,62.37,105,37.63
1311,13,11,346,228,65.9,118,34.1
1312,13,12,320,207,64.69,113,35.31
1313,13,13,338,248,73.37,90,26.63
1314,13,14,335,249,74.33,86,25.67
1315,13,15,487,339,69.61,148,30.39
1316,13,16,262,188,71.76,74,28.24
1317,13,17,311,205,65.92,106,34.08
1318,13,18,282,196,69.5,86,30.5
1319,13,19,444,322,72.52,122,27.48
1320,13,20,225,144,64.0,81,36.0
1321,13,21,365,243,66.58,122,33.42
1322,13,22,351,240,68.38,111,31.62
1323,13,23,292,202,69.18,90,30.82
1324,13,24,351,243,69.23,108,30.77
1325,13,25,352,242,68.75,110,31.25
1326,13,26,351,251,71.51,100,28.49
1327,13,27,315,218,69.21,97,30.79
1328,13,28,266,191,71.8,75,28.2
1329,13,29,292,198,67.81,94,32.19
1330,13,30,275,211,76.73,64,23.27
1331,13,31,363,246,67.77,117,32.23
1332,13,32,296,195,65.88,101,34.12
1333,13,33,336,244,72.62,92,27.38
1334,13,34,347,261,75.22,86,24.78
1335,13,35,302,236,78.15,66,21.85
1336,13,36,255,177,69.41,78,30.59
1337,13,37,330,255,77.27,75,22.73
1338,13,38,281,198,70.46,83,29.54
1339,13,39,328,247,75.3,81,24.7
1340,13,40,316,239,75.63,77,24.37
1341,13,41,429,312,72.73,117,27.27
1342,13,42,338,228,67.46,110,32.54
1343,13,43,325,213,65.54,112,34.46
1344,13,44,355,238,67.04,117,32.96
1345,13,45,361,254,70.36,107,29.64
1346,13,46,404,288,71.29,116,28.71
1347,13,47,367,267,72.75,100,27.25
1348,13,48,278,194,69.78,84,30.22
1401,14,1,370,249,67.3,121,32.7
1402,14,2,529,380,71.83,149,28.17
1403,14,3,367,268,73.02,99,26.98
1404,14,4,360,231,64.17,129,35.83
1405,14,5,537,365,67.97,172,32.03
1406,14,6,211,152,72.04,59,27.96
1407,14,7,508,374,73.62,134,26.38
1408,14,8,464,319,68.75,145,31.25
1409,14,9,458,281,61.35,177,38.65
1410,14,10,283,191,67.49,92,32.51
1411,14,11,229,159,69.43,70,30.57
1412,14,12,401,280,69.83,121,30.17
1413,14,13,355,242,68.17,113,31.83
1414,14,14,361,264,73.13,97,26.87
1415,14,15,383,271,70.76,112,29.24
1416,14,16,274,194,70.8,80,29.2
1417,14,17,329,204,62.01,125,37.99
1418,14,18,185,136,73.51,49,26.49
1419,14,19,360,274,76.11,86,23.89
1420,14,20,307,229,74.59,78,25.41
1421,14,21,374,264,70.59,110,29.41
1422,14,22,497,354,71.23,143,28.77
1423,14,23,269,169,62.83,100,37.17
1424,14,24,415,297,71.57,118,28.43
1425,14,25,187,126,67.38,61,32.62
1426,14,26,286,200,69.93,86,30.07
1427,14,27,356,252,70.79,104,29.21
1428,14,28,338,235,69.53,103,30.47
1429,14,29,282,189,67.02,93,32.98
1430,14,30,265,197,74.34,68,25.66
1431,14,31,216,156,72.22,60,27.78
1501,15,1,324,211,65.12,113,34.88
1502,15,2,193,120,62.18,73,37.82
1503,15,3,205,142,69.27,63,30.73
1504,15,4,362,254,70.17,108,29.83
1505,15,5,339,226,66.67,113,33.33
1506,15,6,383,277,72.32,106,27.68
1507,15,7,179,110,61.45,69,38.55
1508,15,8,367,238,64.85,129,35.15
1509,15,9,477,322,67.51,155,32.49
1510,15,10,496,334,67.34,162,32.66
1511,15,11,436,294,67.43,142,32.57
1512,15,12,458,327,71.4,131,28.6
1513,15,13,370,257,69.46,113,30.54
1514,15,14,327,223,68.2,104,31.8
1515,15,15,318,212,66.67,106,33.33
1516,15,16,413,286,69.25,127,30.75
1517,15,17,189,120,63.49,69,36.51
1518,15,18,131,75,57.25,56,42.75
1519,15,19,289,202,69.9,87,30.1
1520,15,20,205,128,62.44,77,37.56
1521,15,21,159,97,61.01,62,38.99
1522,15,22,188,107,56.91,81,43.09
1523,15,23,211,140,66.35,71,33.65
1524,15,24,183,101,55.19,82,44.81
1601,16,1,437,317,72.54,120,27.46
1602,16,2,253,150,59.29,103,40.71
1603,16,3,222,136,61.26,86,38.74
1604,16,4,294,174,59.18,120,40.82
1605,16,5,194,124,63.92,70,36.08
1606,16,6,229,139,60.7,90,39.3
1607,16,7,269,173,64.31,96,35.69
1608,16,8,189,122,64.55,67,35.45
1609,16,9,265,162,61.13,103,38.87
1610,16,10,220,140,63.64,80,36.36
1611,16,11,291,173,59.45,118,40.55
1612,16,12,253,172,67.98,81,32.02
1613,16,13,339,236,69.62,103,30.38
1614,16,14,199,125,62.81,74,37.19
1615,16,15,257,155,60.31,102,39.69
1616,16,16,205,128,62.44,77,37.56
1617,16,17,382,280,73.3,102,26.7
1618,16,18,317,218,68.77,99,31.23
1619,16,19,261,159,60.92,102,39.08
1620,16,20,163,109,66.87,54,33.13
1621,16,21,218,153,70.18,65,29.82
1622,16,22,223,146,65.47,77,34.53
1623,16,23,373,261,69.97,112,30.03
1624,16,24,128,95,74.22,33,25.78
1625,16,25,297,180,60.61,117,39.39
1626,16,26,170,105,61.76,65,38.24
1627,16,27,181,106,58.56,75,41.44
1628,16,28,195,130,66.67,65,33.33
1629,16,29,196,134,68.37,62,31.63
1630,16,30,185,125,67.57,60,32.43
1631,16,31,236,138,58.47,98,41.53
1632,16,32,375,250,66.67,125,33.33
1633,16,33,186,112,60.22,74,39.78
1634,16,34,219,152,69.41,67,30.59
1635,16,35,415,267,64.34,148,35.66
1636,16,36,172,110,63.95,62,36.05
1701,17,1,361,233,64.54,128,35.46
1702,17,2,291,184,63.23,107,36.77
1703,17,3,298,189,63.42,109,36.58
1704,17,4,318,190,59.75,128,40.25
1705,17,5,241,146,60.58,95,39.42
1706,17,6,331,221,66.77,110,33.23
1707,17,7,343,225,65.6,118,34.4
1708,17,8,214,140,65.42,74,34.58
1709,17,9,243,162,66.67,81,33.33
1710,17,10,392,257,65.56,135,34.44
1711,17,11,232,161,69.4,71,30.6
1712,17,12,483,325,67.29,158,32.71
1713,17,13,221,146,66.06,75,33.94
1714,17,14,373,283,75.87,90,24.13
1715,17,15,323,210,65.02,113,34.98
1716,17,16,386,250,64.77,136,35.23
1717,17,17,332,211,63.55,121,36.45
1718,17,18,361,253,70.08,108,29.92
1719,17,19,194,115,59.28,79,40.72
1720,17,20,387,281,72.61,106,27.39
1721,17,21,361,248,68.7,113,31.3
1722,17,22,302,206,68.21,96,31.79
1723,17,23,209,142,67.94,67,32.06
1724,17,24,250,180,72.0,70,28.0
1725,17,25,256,166,64.84,90,35.16
1726,17,26,308,211,68.51,97,31.49
1727,17,27,189,121,64.02,68,35.98
1728,17,28,222,155,69.82,67,30.18
1729,17,29,284,191,67.25,93,32.75
1730,17,30,330,225,68.18,105,31.82
1731,17,31,201,137,68.16,64,31.84
1732,17,32,235,163,69.36,72,30.64
1733,17,33,188,112,59.57,76,40.43
1734,17,34,235,169,71.91,66,28.09
1735,17,35,213,140,65.73,73,34.27
1736,17,36,229,155,67.69,74,32.31
1737,17,37,249,169,67.87,80,32.13
1738,17,38,343,235,68.51,108,31.49
1739,17,39,287,198,68.99,89,31.01
1740,17,40,346,232,67.05,114,32.95
1741,17,41,412,271,65.78,141,34.22
1801,18,1,360,225,62.5,135,37.5
1802,18,2,432,288,66.67,144,33.33
1803,18,3,317,214,67.51,103,32.49
1804,18,4,377,248,65.78,129,34.22
1805,18,5,219,134,61.19,85,38.81
1806,18,6,341,243,71.26,98,28.74
1807,18,7,371,258,69.54,113,30.46
1808,18,8,369,239,64.77,130,35.23
1809,18,9,339,232,68.44,107,31.56
1810,18,10,453,305,67.33,148,32.67
1811,18,11,349,229,65.62,120,34.38
1812,18,12,351,234,66.67,117,33.33
1813,18,13,394,255,64.72,139,35.28
1814,18,14,374,267,71.39,107,28.61
1815,18,15,390,266,68.21,124,31.79
1816,18,16,346,234,67.63,112,32.37
1817,18,17,397,268,67.51,129,32.49
1818,18,18,267,176,65.92,91,34.08
1819,18,19,300,207,69.0,93,31.0
1820,18,20,246,172,69.92,74,30.08
1821,18,21,456,292,64.04,164,35.96
1822,18,22,377,259,68.7,118,31.3
1823,18,23,358,213,59.5,145,40.5
1824,18,24,352,247,70.17,105,29.83
1825,18,25,392,276,70.41,116,29.59
1826,18,26,443,301,67.95,142,32.05
1827,18,27,322,217,67.39,105,32.61
1828,18,28,328,238,72.56,90,27.44
1829,18,29,438,300,68.49,138,31.51
1830,18,30,454,299,65.86,155,34.14
1831,18,31,389,256,65.81,133,34.19
1832,18,32,358,243,67.88,115,32.12
1833,18,33,268,182,67.91,86,32.09
1834,18,34,395,263,66.58,132,33.42
1835,18,35,418,297,71.05,121,28.95
1836,18,36,398,269,67.59,129,32.41
1837,18,37,414,281,67.87,133,32.13
1838,18,38,320,199,62.19,121,37.81
1839,18,39,302,206,68.21,96,31.79
1840,18,40,396,292,73.74,104,26.26
1841,18,41,441,299,67.8,142,32.2
1842,18,42,323,214,66.25,109,33.75
1843,18,43,329,237,72.04,92,27.96
1844,18,44,337,230,68.25,107,31.75
1845,18,45,386,289,74.87,97,25.13
1846,18,46,439,272,61.96,167,38.04
1847,18,47,279,185,66.31,94,33.69
1848,18,48,273,189,69.23,84,30.77
1849,18,49,234,148,63.25,86,36.75
1850,18,50,251,168,66.93,83,33.07
1901,19,1,351,236,67.24,115,32.76
1902,19,2,504,351,69.64,153,30.36
1903,19,3,308,186,60.39,122,39.61
1904,19,4,452,281,62.17,171,37.83
1905,19,5,417,310,74.34,107,25.66
1906,19,6,421,266,63.18,155,36.82
1907,19,7,333,222,66.67,111,33.33
1908,19,8,417,270,64.75,147,35.25
1909,19,9,274,191,69.71,83,30.29
1910,19,10,497,351,70.62,146,29.38
1911,19,11,359,208,57.94,151,42.06
1912,19,12,315,177,56.19,138,43.81
1913,19,13,478,292,61.09,186,38.91
1914,19,14,404,294,72.77,110,27.23
1915,19,15,532,330,62.03,202,37.97
1916,19,16,382,227,59.42,155,40.58
1917,19,17,345,223,64.64,122,35.36
1918,19,18,377,299,79.31,78,20.69
1919,19,19,484,362,74.79,122,25.21
1920,19,20,320,241,75.31,79,24.69
1921,19,21,415,249,60.0,166,40.0
1922,19,22,424,323,76.18,101,23.82
1923,19,23,391,285,72.89,106,27.11
1924,19,24,300,186,62.0,114,38.0
1925,19,25,377,279,74.01,98,25.99
1926,19,26,370,268,72.43,102,27.57
1927,19,27,403,272,67.49,131,32.51
1928,19,28,458,306,66.81,152,33.19
1929,19,29,403,248,61.54,155,38.46
1930,19,30,380,230,60.53,150,39.47
1931,19,31,348,260,74.71,88,25.29
1932,19,32,366,226,61.75,140,38.25
1933,19,33,426,277,65.02,149,34.98
1934,19,34,344,255,74.13,89,25.87
1935,19,35,352,266,75.57,86,24.43
1936,19,36,541,358,66.17,183,33.83
1937,19,37,405,285,70.37,120,29.63
1938,19,38,360,232,64.44,128,35.56
1939,19,39,199,127,63.82,72,36.18
1940,19,40,433,308,71.13,125,28.87
1941,19,41,372,240,64.52,132,35.48
1942,19,42,322,234,72.67,88,27.33
1943,19,43,532,342,64.29,190,35.71
1944,19,44,440,281,63.86,159,36.14
1945,19,45,418,274,65.55,144,34.45
1946,19,46,368,263,71.47,105,28.53
1947,19,47,575,393,68.35,182,31.65
1948,19,48,461,312,67.68,149,32.32
1949,19,49,486,321,66.05,165,33.95
1950,19,50,352,235,66.76,117,33.24
1951,19,51,418,293,70.1,125,29.9
1952,19,52,495,302,61.01,193,38.99
1953,19,53,359,260,72.42,99,27.58
1954,19,54,309,164,53.07,145,46.93
1955,19,55,329,206,62.61,123,37.39
1956,19,56,423,313,74.0,110,26.0
1957,19,57,336,254,75.6,82,24.4
2001,20,1,389,244,62.72,145,37.28
2002,20,2,119,72,60.5,47,39.5
2003,20,3,342,213,62.28,129,37.72
2004,20,4,156,94,60.26,62,39.74
2005,20,5,393,242,61.58,151,38.42
2006,20,6,148,95,64.19,53,35.81
2007,20,7,427,271,63.47,156,36.53
2008,20,8,311,217,69.77,94,30.23
2009,20,9,500,303,60.6,197,39.4
2010,20,10,240,160,66.67,80,33.33
2011,20,11,456,262,57.46,194,42.54
2012,20,12,342,216,63.16,126,36.84
2013,20,13,306,203,66.34,103,33.66
2014,20,14,182,122,67.03,60,32.97
2015,20,15,362,248,68.51,114,31.49
2016,20,16,426,286,67.14,140,32.86
2017,20,17,238,158,66.39,80,33.61
2018,20,18,238,134,56.3,104,43.7
2019,20,19,376,236,62.77,140,37.23
2020,20,20,282,185,65.6,97,34.4
2021,20,21,289,180,62.28,109,37.72
2022,20,22,487,308,63.24,179,36.76
2023,20,23,198,132,66.67,66,33.33
2024,20,24,440,270,61.36,170,38.64
2025,20,25,226,140,61.95,86,38.05
2026,20,26,331,226,68.28,105,31.72
2027,20,27,166,116,69.88,50,30.12
2028,20,28,214,145,67.76,69,32.24
2029,20,29,238,147,61.76,91,38.24
2030,20,30,157,106,67.52,51,32.48
2031,20,31,397,249,62.72,148,37.28
2032,20,32,266,172,64.66,94,35.34
2033,20,33,223,147,65.92,76,34.08
2034,20,34,443,294,66.37,149,33.63
2035,20,35,260,146,56.15,114,43.85
2036,20,36,117,79,67.52,38,32.48
2037,20,37,112,65,58.04,47,41.96
2038,20,38,97,63,64.95,34,35.05
2039,20,39,27,17,62.96,10,37.04
2101,21,1,388,252,64.95,136,35.05
2102,21,2,233,124,53.22,109,46.78
2103,21,3,349,239,68.48,110,31.52
2104,21,4,299,215,71.91,84,28.09
2105,21,5,359,231,64.35,128,35.65
2106,21,6,289,185,64.01,104,35.99
2107,21,7,338,233,68.93,105,31.07
2108,21,8,356,245,68.82,111,31.18
2109,21,9,359,249,69.36,110,30.64
2110,21,10,285,188,65.96,97,34.04
2111,21,11,299,192,64.21,107,35.79
2112,21,12,299,194,64.88,105,35.12
2113,21,13,368,234,63.59,134,36.41
2114,21,14,384,253,65.89,131,34.11
2115,21,15,322,213,66.15,109,33.85
2116,21,16,301,192,63.79,109,36.21
2117,21,17,289,189,65.4,100,34.6
2118,21,18,304,192,63.16,112,36.84
2119,21,19,403,259,64.27,144,35.73
2120,21,20,307,209,68.08,98,31.92
2121,21,21,305,183,60.0,122,40.0
2122,21,22,302,196,64.9,106,35.1
2123,21,23,321,209,65.11,112,34.89
2124,21,24,366,247,67.49,119,32.51
2125,21,25,290,179,61.72,111,38.28
2126,21,26,351,205,58.4,146,41.6
2127,21,27,401,258,64.34,143,35.66
2128,21,28,418,263,62.92,155,37.08
2129,21,29,376,243,64.63,133,35.37
2130,21,30,287,166,57.84,121,42.16
2131,21,31,199,147,73.87,52,26.13
2132,21,32,254,170,66.93,84,33.07
2133,21,33,277,183,66.06,94,33.94
2134,21,34,323,209,64.71,114,35.29
2135,21,35,404,280,69.31,124,30.69
2136,21,36,336,211,62.8,125,37.2
2137,21,37,238,159,66.81,79,33.19
2138,21,38,348,217,62.36,131,37.64
2139,21,39,338,208,61.54,130,38.46
2140,21,40,310,204,65.81,106,34.19
2141,21,41,360,229,63.61,131,36.39
2142,21,42,371,236,63.61,135,36.39
2143,21,43,345,209,60.58,136,39.42
2144,21,44,361,238,65.93,123,34.07
2145,21,45,328,215,65.55,113,34.45
2146,21,46,358,244,68.16,114,31.84
2147,21,47,318,194,61.01,124,38.99
2148,21,48,351,241,68.66,110,31.34
2149,21,49,385,255,66.23,130,33.77
2150,21,50,262,167,63.74,95,36.26
2151,21,51,362,242,66.85,120,33.15
2152,21,52,337,208,61.72,129,38.28
2153,21,53,302,198,65.56,104,34.44
2154,21,54,262,188,71.76,74,28.24
2201,22,1,186,121,65.05,65,34.95
2202,22,2,444,308,69.37,136,30.63
2203,22,3,546,364,66.67,182,33.33
2204,22,4,298,217,72.82,81,27.18
2205,22,5,338,245,72.49,93,27.51
2206,22,6,329,242,73.56,87,26.44
2207,22,7,289,212,73.36,77,26.64
2208,22,8,501,368,73.45,133,26.55
2209,22,9,288,222,77.08,66,22.92
2210,22,10,460,293,63.7,167,36.3
2211,22,11,244,157,64.34,87,35.66
2212,22,12,270,177,65.56,93,34.44
2213,22,13,370,251,67.84,119,32.16
2214,22,14,291,200,68.73,91,31.27
2215,22,15,301,197,65.45,104,34.55
2216,22,16,296,203,68.58,93,31.42
2217,22,17,472,315,66.74,157,33.26
2218,22,18,333,225,67.57,108,32.43
2219,22,19,168,119,70.83,49,29.17
2220,22,20,378,256,67.72,122,32.28
2221,22,21,321,213,66.36,108,33.64
2222,22,22,346,227,65.61,119,34.39
2223,22,23,345,239,69.28,106,30.72
2224,22,24,424,303,71.46,121,28.54
2225,22,25,342,258,75.44,84,24.56
2301,23,1,322,208,64.6,114,35.4
2302,23,2,362,241,66.57,121,33.43
2303,23,3,316,204,64.56,112,35.44
2304,23,4,326,237,72.7,89,27.3
2305,23,5,364,266,73.08,98,26.92
2306,23,6,345,253,73.33,92,26.67
2307,23,7,357,256,71.71,101,28.29
2308,23,8,436,282,64.68,154,35.32
2309,23,9,350,240,68.57,110,31.43
2310,23,10,417,299,71.7,118,28.3
2311,23,11,414,317,76.57,97,23.43
2312,23,12,365,249,68.22,116,31.78
2313,23,13,345,238,68.99,107,31.01
2314,23,14,297,191,64.31,106,35.69
2315,23,15,325,218,67.08,107,32.92
2316,23,16,341,230,67.45,111,32.55
2317,23,17,290,191,65.86,99,34.14
2318,23,18,327,222,67.89,105,32.11
2319,23,19,311,210,67.52,101,32.48
2320,23,20,258,182,70.54,76,29.46
2321,23,21,307,198,64.5,109,35.5
2322,23,22,339,238,70.21,101,29.79
2323,23,23,332,211,63.55,121,36.45
2324,23,24,323,220,68.11,103,31.89
2325,23,25,322,220,68.32,102,31.68
2326,23,26,361,265,73.41,96,26.59
2327,23,27,304,201,66.12,103,33.88
2328,23,28,392,264,67.35,128,32.65
2329,23,29,300,209,69.67,91,30.33
2330,23,30,440,314,71.36,126,28.64
2331,23,31,303,205,67.66,98,32.34
2332,23,32,355,252,70.99,103,29.01
2333,23,33,401,292,72.82,109,27.18
2334,23,34,396,275,69.44,121,30.56
2335,23,35,254,171,67.32,83,32.68
2336,23,36,347,244,70.32,103,29.68
2337,23,37,375,237,63.2,138,36.8
2338,23,38,322,234,72.67,88,27.33
2339,23,39,390,281,72.05,109,27.95
2401,24,1,236,150,63.56,86,36.44
2402,24,2,279,168,60.22,111,39.78
2403,24,3,347,217,62.54,130,37.46
2404,24,4,234,157,67.09,77,32.91
2405,24,5,160,112,70.0,48,30.0
2406,24,6,322,195,60.56,127,39.44
2407,24,7,232,158,68.1,74,31.9
2408,24,8,129,82,63.57,47,36.43
2409,24,9,269,169,62.83,100,37.17
2410,24,10,141,86,60.99,55,39.01
2411,24,11,288,169,58.68,119,41.32
2412,24,12,183,107,58.47,76,41.53
2413,24,13,179,103,57.54,76,42.46
2414,24,14,228,142,62.28,86,37.72
2415,24,15,154,98,63.64,56,36.36
2416,24,16,866,458,52.89,408,47.11
2417,24,17,202,125,61.88,77,38.12
2418,24,18,240,148,61.67,92,38.33
2419,24,19,314,195,62.1,119,37.9
2420,24,20,247,152,61.54,95,38.46
2421,24,21,154,91,59.09,63,40.91
2422,24,22,336,204,60.71,132,39.29
2423,24,23,251,151,60.16,100,39.84
2424,24,24,330,175,53.03,155,46.97
2425,24,25,206,130,63.11,76,36.89
2426,24,26,408,299,73.28,109,26.72
2427,24,27,306,214,69.93,92,30.07
2428,24,28,170,113,66.47,57,33.53
2429,24,29,205,135,65.85,70,34.15
2430,24,30,178,114,64.04,64,35.96
2431,24,31,293,168,57.34,125,42.66
2432,24,32,139,91,65.47,48,34.53
2433,24,33,176,109,61.93,67,38.07
2434,24,34,269,173,64.31,96,35.69
2435,24,35,258,153,59.3,105,40.7
2436,24,36,330,201,60.91,129,39.09
2437,24,37,132,90,68.18,42,31.82
2438,24,38,243,146,60.08,97,39.92
2439,24,39,272,171,62.87,101,37.13
2440,24,40,326,190,58.28,136,41.72
2441,24,41,127,81,63.78,46,36.22
2501,25,1,366,230,62.84,136,37.16
2502,25,2,555,330,59.46,225,40.54
2503,25,3,714,549,76.89,165,23.11
2504,25,4,345,230,66.67,115,33.33
2505,25,5,436,275,63.07,161,36.93
2506,25,6,140,95,67.86,45,32.14
2507,25,7,458,275,60.04,183,39.96
2508,25,8,525,288,54.86,237,45.14
2509,25,9,445,284,63.82,161,36.18
2510,25,10,586,462,78.84,124,21.16
2511,25,11,498,316,63.45,182,36.55
2512,25,12,448,269,60.04,179,39.96
2513,25,13,524,336,64.12,188,35.88
2514,25,14,289,217,75.09,72,24.91
2515,25,15,391,230,58.82,161,41.18
2516,25,16,702,555,79.06,147,20.94
2517,25,17,460,296,64.35,164,35.65
2518,25,18,216,158,73.15,58,26.85
2519,25,19,466,259,55.58,207,44.42
2520,25,20,246,134,54.47,112,45.53
2521,25,21,850,658,77.41,192,22.59
2522,25,22,466,278,59.66,188,40.34
2523,25,23,513,337,65.69,176,34.31
2524,25,24,465,302,64.95,163,35.05
2525,25,25,388,285,73.45,103,26.55
2526,25,26,464,293,63.15,171,36.85
2527,25,27,569,432,75.92,137,24.08
2528,25,28,492,299,60.77,193,39.23
2529,25,29,324,215,66.36,109,33.64
2530,25,30,458,256,55.9,202,44.1
2531,25,31,816,624,76.47,192,23.53
2532,25,32,358,209,58.38,149,41.62
2601,26,1,381,218,57.22,163,42.78
2602,26,2,274,141,51.46,133,48.54
2603,26,3,426,286,67.14,140,32.86
2604,26,4,255,156,61.18,99,38.82
2605,26,5,317,172,54.26,145,45.74
2606,26,6,297,204,68.69,93,31.31
2607,26,7,338,208,61.54,130,38.46
2608,26,8,216,141,65.28,75,34.72
2609,26,9,283,188,66.43,95,33.57
2610,26,10,357,215,60.22,142,39.78
2611,26,11,328,189,57.62,139,42.38
2612,26,12,348,196,56.32,152,43.68
2613,26,13,181,126,69.61,55,30.39
2614,26,14,280,168,60.0,112,40.0
2615,26,15,214,144,67.29,70,32.71
2616,26,16,189,121,64.02,68,35.98
2617,26,17,315,218,69.21,97,30.79
2618,26,18,256,174,67.97,82,32.03
2619,26,19,208,135,64.9,73,35.1
2620,26,20,301,188,62.46,113,37.54
2621,26,21,429,261,60.84,168,39.16
2622,26,22,189,127,67.2,62,32.8
2623,26,23,244,158,64.75,86,35.25
2624,26,24,275,164,59.64,111,40.36
2625,26,25,255,138,54.12,117,45.88
2626,26,26,255,144,56.47,111,43.53
2627,26,27,384,227,59.11,157,40.89
2628,26,28,453,313,69.09,140,30.91
2629,26,29,181,105,58.01,76,41.99
2630,26,30,281,154,54.8,127,45.2
2631,26,31,157,98,62.42,59,37.58
2632,26,32,405,272,67.16,133,32.84
2633,26,33,387,222,57.36,165,42.64
2634,26,34,359,209,58.22,150,41.78
2635,26,35,280,162,57.86,118,42.14
2636,26,36,343,206,60.06,137,39.94
2637,26,37,360,230,63.89,130,36.11
2638,26,38,169,114,67.46,55,32.54
2639,26,39,405,243,60.0,162,40.0
2640,26,40,197,114,57.87,83,42.13
2641,26,41,393,247,62.85,146,37.15
2642,26,42,276,162,58.7,114,41.3
2643,26,43,225,158,70.22,67,29.78
2644,26,44,181,129,71.27,52,28.73
2645,26,45,176,105,59.66,71,40.34
2646,26,46,249,157,63.05,92,36.95
2647,26,47,237,165,69.62,72,30.38
2648,26,48,357,219,61.34,138,38.66
2649,26,49,214,151,70.56,63,29.44
2701,27,1,898,647,72.05,251,27.95
2702,27,2,405,300,74.07,105,25.93
2703,27,3,171,104,60.82,67,39.18
2704,27,4,203,116,57.14,87,42.86
2705,27,5,297,184,61.95,113,38.05
2706,27,6,445,327,73.48,118,26.52
2707,27,7,573,389,67.89,184,32.11
2708,27,8,321,205,63.86,116,36.14
2709,27,9,184,137,74.46,47,25.54
2710,27,10,250,173,69.2,77,30.8
2711,27,11,453,352,77.7,101,22.3
2712,27,12,301,234,77.74,67,22.26
2713,27,13,524,379,72.33,145,27.67
2714,27,14,189,125,66.14,64,33.86
2715,27,15,177,105,59.32,72,40.68
2716,27,16,454,330,72.69,124,27.31
2717,27,17,391,258,65.98,133,34.02
2718,27,18,239,144,60.25,95,39.75
2719,27,19,177,117,66.1,60,33.9
2720,27,20,271,160,59.04,111,40.96
2721,27,21,359,266,74.09,93,25.91
2722,27,22,153,96,62.75,57,37.25
2723,27,23,215,130,60.47,85,39.53
2724,27,24,253,162,64.03,91,35.97
2725,27,25,348,214,61.49,134,38.51
2726,27,26,245,151,61.63,94,38.37
2727,27,27,495,315,63.64,180,36.36
2728,27,28,508,386,75.98,122,24.02
2729,27,29,252,155,61.51,97,38.49
2730,27,30,170,117,68.82,53,31.18
2731,27,31,265,163,61.51,102,38.49
2732,27,32,355,237,66.76,118,33.24
2733,27,33,546,404,73.99,142,26.01
2734,27,34,192,115,59.9,77,40.1
2735,27,35,516,373,72.29,143,27.71
2736,27,36,276,181,65.58,95,34.42
2737,27,37,338,247,73.08,91,26.92
2738,27,38,509,380,74.66,129,25.34
2739,27,39,261,163,62.45,98,37.55
2740,27,40,544,368,67.65,176,32.35
2741,27,41,249,161,64.66,88,35.34
2742,27,42,252,184,73.02,68,26.98
2743,27,43,307,201,65.47,106,34.53
2744,27,44,260,161,61.92,99,38.08
2745,27,45,1106,828,74.86,278,25.14
2746,27,46,346,269,77.75,77,22.25
2747,27,47,223,173,77.58,50,22.42
2748,27,48,676,490,72.49,186,27.51
2749,27,49,260,172,66.15,88,33.85
2750,27,50,312,193,61.86,119,38.14
2801,28,1,207,125,60.39,82,39.61
2802,28,2,249,162,65.06,87,34.94
2803,28,3,215,139,64.65,76,35.35
2804,28,4,278,205,73.74,73,26.26
2805,28,5,176,122,69.32,54,30.68
2806,28,6,170,131,77.06,39,22.94
2807,28,7,261,181,69.35,80,30.65
2808,28,8,481,365,75.88,116,24.12
2809,28,9,279,196,70.25,83,29.75
2810,28,10,379,264,69.66,115,30.34
2811,28,11,693,455,65.66,238,34.34
2812,28,12,251,171,68.13,80,31.87
2813,28,13,267,186,69.66,81,30.34
2814,28,14,271,178,65.68,93,34.32
2815,28,15,53,37,69.81,16,30.19
2816,28,16,180,117,65.0,63,35.0
2817,28,17,239,155,64.85,84,35.15
2818,28,18,237,152,64.14,85,35.86
2819,28,19,277,187,67.51,90,32.49
2820,28,20,230,148,64.35,82,35.65
2821,28,21,247,157,63.56,90,36.44
2822,28,22,261,171,65.52,90,34.48
2823,28,23,325,219,67.38,106,32.62
2824,28,24,247,147,59.51,100,40.49
2825,28,25,426,269,63.15,157,36.85
2826,28,26,244,149,61.07,95,38.93
2827,28,27,324,235,72.53,89,27.47
2828,28,28,398,290,72.86,108,27.14
2829,28,29,148,94,63.51,54,36.49
2830,28,30,45,32,71.11,13,28.89
2831,28,31,300,207,69.0,93,31.0
2832,28,32,268,160,59.7,108,40.3
2833,28,33,299,191,63.88,108,36.12
2834,28,34,501,304,60.68,197,39.32
2835,28,35,295,201,68.14,94,31.86
2836,28,36,131,78,59.54,53,40.46
2837,28,37,305,195,63.93,110,36.07
2838,28,38,115,85,73.91,30,26.09
2839,28,39,209,139,66.51,70,33.49
2840,28,40,352,231,65.63,121,34.38
2841,28,41,182,113,62.09,69,37.91
2842,28,42,289,185,64.01,104,35.99
2843,28,43,326,213,65.34,113,34.66
2844,28,44,216,133,61.57,83,38.43
2845,28,45,456,335,73.46,121,26.54
2846,28,46,585,385,65.81,200,34.19
2901,29,1,524,367,70.04,157,29.96
2902,29,2,431,279,64.73,152,35.27
2903,29,3,301,191,63.46,110,36.54
2904,29,4,425,291,68.47,134,31.53
2905,29,5,266,166,62.41,100,37.59
2906,29,6,256,176,68.75,80,31.25
2907,29,7,392,259,66.07,133,33.93
2908,29,8,337,226,67.06,111,32.94
2909,29,9,424,311,73.35,113,26.65
2910,29,10,486,355,73.05,131,26.95
2911,29,11,193,127,65.8,66,34.2
2912,29,12,451,316,70.07,135,29.93
2913,29,13,331,210,63.44,121,36.56
2914,29,14,311,220,70.74,91,29.26
2915,29,15,403,281,69.73,122,30.27
2916,29,16,349,226,64.76,123,35.24
2917,29,17,351,261,74.36,90,25.64
2918,29,18,327,213,65.14,114,34.86
2919,29,19,349,238,68.19,111,31.81
2920,29,20,376,231,61.44,145,38.56
2921,29,21,442,263,59.5,179,40.5
2922,29,22,265,175,66.04,90,33.96
2923,29,23,448,307,68.53,141,31.47
2924,29,24,353,244,69.12,109,30.88
2925,29,25,418,290,69.38,128,30.62
2926,29,26,332,239,71.99,93,28.01
2927,29,27,331,217,65.56,114,34.44
2928,29,28,420,276,65.71,144,34.29
2929,29,29,435,299,68.74,136,31.26
2930,29,30,515,357,69.32,158,30.68
2931,29,31,398,262,65.83,136,34.17
2932,29,32,413,298,72.15,115,27.85
2933,29,33,237,168,70.89,69,29.11
2934,29,34,256,157,61.33,99,38.67
2935,29,35,281,175,62.28,106,37.72
2936,29,36,327,229,70.03,98,29.97
2937,29,37,337,219,64.99,118,35.01
2938,29,38,481,337,70.06,144,29.94
2939,29,39,411,293,71.29,118,28.71
2940,29,40,400,275,68.75,125,31.25
2941,29,41,306,209,68.3,97,31.7
2942,29,42,383,253,66.06,130,33.94
2943,29,43,462,325,70.35,137,29.65
2944,29,44,380,251,66.05,129,33.95
3001,30,1,458,318,69.43,140,30.57
3002,30,2,413,291,70.46,122,29.54
3003,30,3,359,236,65.74,123,34.26
3004,30,4,406,273,67.24,133,32.76
3005,30,5,330,226,68.48,104,31.52
3006,30,6,282,198,70.21,84,29.79
3007,30,7,459,289,62.96,170,37.04
3008,30,8,518,303,58.49,215,41.51
3009,30,9,351,237,67.52,114,32.48
3010,30,10,396,285,71.97,111,28.03
3011,30,11,420,297,70.71,123,29.29
3012,30,12,379,265,69.92,114,30.08
3013,30,13,418,294,70.33,124,29.67
3014,30,14,304,214,70.39,90,29.61
3015,30,15,374,281,75.13,93,24.87
3016,30,16,224,161,71.88,63,28.13
3017,30,17,426,309,72.54,117,27.46
3018,30,18,530,349,65.85,181,34.15
3019,30,19,445,305,68.54,140,31.46
3020,30,20,440,287,65.23,153,34.77
3021,30,21,289,211,73.01,78,26.99
3022,30,22,622,395,63.5,227,36.5
3023,30,23,547,361,66.0,186,34.0
3024,30,24,625,345,55.2,280,44.8
3025,30,25,640,372,58.13,268,41.88
3026,30,26,264,175,66.29,89,33.71
3027,30,27,302,209,69.21,93,30.79
3028,30,28,449,291,64.81,158,35.19
3029,30,29,297,201,67.68,96,32.32
3030,30,30,181,129,71.27,52,28.73
3031,30,31,260,181,69.62,79,30.38
3032,30,32,343,234,68.22,109,31.78
3101,31,1,271,177,65.31,94,34.69
3102,31,2,252,190,75.4,62,24.6
3103,31,3,265,187,70.57,78,29.43
3104,31,4,372,215,57.8,157,42.2
3105,31,5,311,215,69.13,96,30.87
3106,31,6,193,139,72.02,54,27.98
3107,31,7,413,265,64.16,148,35.84
3108,31,8,268,187,69.78,81,30.22
3109,31,9,323,226,69.97,97,30.03
3110,31,10,343,244,71.14,99,28.86
3111,31,11,211,141,66.82,70,33.18
3112,31,12,237,171,72.15,66,27.85
3113,31,13,313,219,69.97,94,30.03
3114,31,14,275,195,70.91,80,29.09
3115,31,15,283,192,67.84,91,32.16
3116,31,16,359,212,59.05,147,40.95
3117,31,17,264,207,78.41,57,21.59
3118,31,18,269,194,72.12,75,27.88
3119,31,19,258,171,66.28,87,33.72
3120,31,20,249,161,64.66,88,35.34
3121,31,21,250,175,70.0,75,30.0
3122,31,22,247,156,63.16,91,36.84
3123,31,23,318,217,68.24,101,31.76
3124,31,24,287,201,70.03,86,29.97
3125,31,25,295,207,70.17,88,29.83
3126,31,26,287,201,70.03,86,29.97
3127,31,27,308,213,69.16,95,30.84
3128,31,28,275,191,69.45,84,30.55
3129,31,29,267,184,68.91,83,31.09
3130,31,30,236,166,70.34,70,29.66
3131,31,31,245,170,69.39,75,30.61
3132,31,32,232,158,68.1,74,31.9
3133,31,33,270,189,70.0,81,30.0
3134,31,34,284,191,67.25,93,32.75
3135,31,35,341,231,67.74,110,32.26
3136,31,36,283,202,71.38,81,28.62
3137,31,37,274,193,70.44,81,29.56
3138,31,38,262,183,69.85,79,30.15
3139,31,39,322,206,63.98,116,36.02
3140,31,40,325,195,60.0,130,40.0
3141,31,41,262,184,70.23,78,29.77
3201,32,1,652,467,71.63,185,28.37
3202,32,2,578,412,71.28,166,28.72
3203,32,3,556,343,61.69,213,38.31
3204,32,4,456,338,74.12,118,25.88
3205,32,5,546,393,71.98,153,28.02
3206,32,6,618,463,74.92,155,25.08
3207,32,7,591,416,70.39,175,29.61
3208,32,8,628,488,77.71,140,22.29
3209,32,9,527,373,70.78,154,29.22
3210,32,10,568,411,72.36,157,27.64
3211,32,11,470,275,58.51,195,41.49
3212,32,12,353,199,56.37,154,43.63
3213,32,13,563,427,75.84,136,24.16
3214,32,14,560,350,62.5,210,37.5
3215,32,15,485,346,71.34,139,28.66
3216,32,16,497,339,68.21,158,31.79
3217,32,17,509,298,58.55,211,41.45
3218,32,18,498,401,80.52,97,19.48
3219,32,19,480,335,69.79,145,30.21
3220,32,20,500,288,57.6,212,42.4
3221,32,21,525,391,74.48,134,25.52
3222,32,22,651,399,61.29,252,38.71
3223,32,23,549,398,72.5,151,27.5
3224,32,24,441,337,76.42,104,23.58
3225,32,25,509,385,75.64,124,24.36
3226,32,26,543,336,61.88,207,38.12
3227,32,27,517,401,77.56,116,22.44
3228,32,28,542,335,61.81,207,38.19
3229,32,29,540,379,70.19,161,29.81
3230,32,30,503,392,77.93,111,22.07
3231,32,31,556,393,70.68,163,29.32
3232,32,32,615,452,73.5,163,26.5
3233,32,33,460,351,76.3,109,23.7
3234,32,34,576,415,72.05,161,27.95
3235,32,35,486,366,75.31,120,24.69
3236,32,36,529,388,73.35,141,26.65
3237,32,37,602,422,70.1,180,29.9
3238,32,38,505,373,73.86,132,26.14
3239,32,39,566,434,76.68,132,23.32
3240,32,40,520,396,76.15,124,23.85
3241,32,41,543,402,74.03,141,25.97
3242,32,42,482,353,73.24,129,26.76
3243,32,43,473,300,63.42,173,36.58
3301,33,1,585,379,64.79,206,35.21
3302,33,2,705,462,65.53,243,34.47
3303,33,3,764,474,62.04,290,37.96
3304,33,4,736,465,63.18,271,36.82
3305,33,5,515,349,67.77,166,32.23
3306,33,6,488,326,66.8,162,33.2
3307,33,7,567,368,64.9,199,35.1
3308,33,8,683,479,70.13,204,29.87
3309,33,9,600,416,69.33,184,30.67
3310,33,10,455,330,72.53,125,27.47
3311,33,11,549,390,71.04,159,28.96
3312,33,12,560,403,71.96,157,28.04
3313,33,13,536,325,60.63,211,39.37
3314,33,14,264,166,62.88,98,37.12
3315,33,15,564,393,69.68,171,30.32
3316,33,16,741,519,70.04,222,29.96
3317,33,17,565,374,66.19,191,33.81
3318,33,18,784,503,64.16,281,35.84
3319,33,19,647,416,64.3,231,35.7
3320,33,20,691,449,64.98,242,35.02
3321,33,21,606,371,61.22,235,38.78
3322,33,22,516,367,71.12,149,28.88
3323,33,23,614,402,65.47,212,34.53
3324,33,24,681,495,72.69,186,27.31
3325,33,25,655,461,70.38,194,29.62
3326,33,26,407,234,57.49,173,42.51
3327,33,27,641,399,62.25,242,37.75
3328,33,28,514,308,59.92,206,40.08
3401,34,1,395,247,62.53,148,37.47
3402,34,2,307,224,72.96,83,27.04
3403,34,3,352,232,65.91,120,34.09
3404,34,4,276,199,72.1,77,27.9
3405,34,5,302,209,69.21,93,30.79
3406,34,6,397,277,69.77,120,30.23
3407,34,7,371,267,71.97,104,28.03
3408,34,8,292,187,64.04,105,35.96
3409,34,9,224,144,64.29,80,35.71
3410,34,10,298,211,70.81,87,29.19
3411,34,11,310,203,65.48,107,34.52
3412,34,12,372,254,68.28,118,31.72
3413,34,13,369,248,67.21,121,32.79
3414,34,14,276,201,72.83,75,27.17
3415,34,15,321,212,66.04,109,33.96
3416,34,16,325,229,70.46,96,29.54
3417,34,17,440,313,71.14,127,28.86
3418,34,18,212,146,68.87,66,31.13
3419,34,19,380,260,68.42,120,31.58
3420,34,20,405,294,72.59,111,27.41
3421,34,21,417,294,70.5,123,29.5
3422,34,22,357,250,70.03,107,29.97
3423,34,23,308,211,68.51,97,31.49
3424,34,24,300,214,71.33,86,28.67
3425,34,25,523,370,70.75,153,29.25
3426,34,26,416,294,70.67,122,29.33
3427,34,27,284,186,65.49,98,34.51
3428,34,28,222,150,67.57,72,32.43
3429,34,29,281,175,62.28,106,37.72
3430,34,30,331,241,72.81,90,27.19
3431,34,31,271,185,68.27,86,31.73
3432,34,32,354,244,68.93,110,31.07
3433,34,33,298,199,66.78,99,33.22
3434,34,34,409,290,70.9,119,29.1
3435,34,35,434,279,64.29,155,35.71
3436,34,36,307,214,69.71,93,30.29
3437,34,37,204,123,60.29,81,39.71
3438,34,38,183,113,61.75,70,38.25
3439,34,39,259,150,57.92,109,42.08
3440,34,40,376,245,65.16,131,34.84
3441,34,41,214,130,60.75,84,39.25
3442,34,42,358,251,70.11,107,29.89
3443,34,43,325,239,73.54,86,26.46
3444,34,44,302,217,71.85,85,28.15
3445,34,45,351,236,67.24,115,32.76
3446,34,46,242,171,70.66,71,29.34
3447,34,47,310,238,76.77,72,23.23
3448,34,48,365,263,72.05,102,27.95
3449,34,49,322,244,75.78,78,24.22
3450,34,50,285,200,70.18,85,29.82
3451,34,51,406,283,69.7,123,30.3
3452,34,52,278,192,69.06,86,30.94
3453,34,53,244,172,70.49,72,29.51
3501,35,1,469,290,61.83,179,38.17
3502,35,2,484,302,62.4,182,37.6
3503,35,3,426,264,61.97,162,38.03
3504,35,4,473,321,67.86,152,32.14
3505,35,5,397,237,59.7,160,40.3
3506,35,6,504,315,62.5,189,37.5
3507,35,7,488,274,56.15,214,43.85
3508,35,8,477,279,58.49,198,41.51
3509,35,9,406,267,65.76,139,34.24
3510,35,10,544,307,56.43,237,43.57
3511,35,11,527,329,62.43,198,37.57
3512,35,12,318,217,68.24,101,31.76
3513,35,13,324,214,66.05,110,33.95
3514,35,14,369,239,64.77,130,35.23
3515,35,15,569,347,60.98,222,39.02
3516,35,16,250,156,62.4,94,37.6
3517,35,17,469,269,57.36,200,42.64
3518,35,18,319,212,66.46,107,33.54
3519,35,19,289,199,68.86,90,31.14
3520,35,20,470,320,68.09,150,31.91
3521,35,21,479,298,62.21,181,37.79
3522,35,22,592,377,63.68,215,36.32
3523,35,23,477,331,69.39,146,30.61
3524,35,24,428,273,63.79,155,36.21
3525,35,25,484,289,59.71,195,40.29
3526,35,26,410,278,67.8,132,32.2
3527,35,27,417,283,67.87,134,32.13
3528,35,28,470,296,62.98,174,37.02
3529,35,29,450,306,68.0,144,32.0
3530,35,30,417,271,64.99,146,35.01
3531,35,31,503,331,65.81,172,34.19
3601,36,1,386,279,72.28,107,27.72
3602,36,2,375,257,68.53,118,31.47
3603,36,3,348,235,67.53,113,32.47
3604,36,4,428,303,70.79,125,29.21
3605,36,5,348,237,68.1,111,31.9
3606,36,6,347,247,71.18,100,28.82
3607,36,7,388,266,68.56,122,31.44
3608,36,8,323,233,72.14,90,27.86
3609,36,9,389,265,68.12,124,31.88
3610,36,10,504,370,73.41,134,26.59
3611,36,11,278,177,63.67,101,36.33
3612,36,12,242,168,69.42,74,30.58
3613,36,13,271,195,71.96,76,28.04
3614,36,14,430,299,69.53,131,30.47
3615,36,15,377,287,76.13,90,23.87
3616,36,16,386,265,68.65,121,31.35
3617,36,17,475,323,68.0,152,32.0
3618,36,18,404,266,65.84,138,34.16
3619,36,19,502,357,71.12,145,28.88
3620,36,20,440,313,71.14,127,28.86
3621,36,21,353,229,64.87,124,35.13
3622,36,22,360,227,63.06,133,36.94
3623,36,23,347,232,66.86,115,33.14
3624,36,24,453,318,70.2,135,29.8
3625,36,25,400,284,71.0,116,29.0
3626,36,26,360,241,66.94,119,33.06
3627,36,27,334,236,70.66,98,29.34
3628,36,28,350,258,73.71,92,26.29
3629,36,29,420,296,70.48,124,29.52
3630,36,30,369,247,66.94,122,33.06
3701,37,1,200,153,76.5,47,23.5
3702,37,2,297,184,61.95,113,38.05
3703,37,3,221,131,59.28,90,40.72
3704,37,4,262,163,62.21,99,37.79
3705,37,5,314,218,69.43,96,30.57
3706,37,6,214,146,68.22,68,31.78
3707,37,7,245,177,72.24,68,27.76
3708,37,8,229,154,67.25,75,32.75
3709,37,9,300,194,64.67,106,35.33
3710,37,10,393,264,67.18,129,32.82
3711,37,11,204,128,62.75,76,37.25
3712,37,12,294,197,67.01,97,32.99
3713,37,13,236,155,65.68,81,34.32
3714,37,14,358,237,66.2,121,33.8
3715,37,15,326,219,67.18,107,32.82
3716,37,16,345,227,65.8,118,34.2
3717,37,17,228,156,68.42,72,31.58
3718,37,18,265,161,60.75,104,39.25
3719,37,19,237,156,65.82,81,34.18
3720,37,20,282,194,68.79,88,31.21
3721,37,21,244,174,71.31,70,28.69
3722,37,22,289,190,65.74,99,34.26
3723,37,23,303,199,65.68,104,34.32
3724,37,24,296,194,65.54,102,34.46
3725,37,25,268,157,58.58,111,41.42
3726,37,26,423,264,62.41,159,37.59
3727,37,27,317,195,61.51,122,38.49
3728,37,28,274,184,67.15,90,32.85
3729,37,29,264,190,71.97,74,28.03
3730,37,30,271,178,65.68,93,34.32
3731,37,31,361,240,66.48,121,33.52
3732,37,32,275,198,72.0,77,28.0
3733,37,33,234,159,67.95,75,32.05
3734,37,34,270,169,62.59,101,37.41
3735,37,35,320,208,65.0,112,35.0
3736,37,36,211,138,65.4,73,34.6
3737,37,37,324,209,64.51,115,35.49
3738,37,38,326,213,65.34,113,34.66
3739,37,39,252,159,63.1,93,36.9
3740,37,40,323,234,72.45,89,27.55
3741,37,41,302,203,67.22,99,32.78
3801,38,1,380,280,73.68,100,26.32
3802,38,2,398,268,67.34,130,32.66
3803,38,3,393,258,65.65,135,34.35
3804,38,4,365,237,64.93,128,35.07
3805,38,5,375,254,67.73,121,32.27
3806,38,6,394,264,67.01,130,32.99
3807,38,7,375,248,66.13,127,33.87
3808,38,8,393,260,66.16,133,33.84
3809,38,9,481,337,70.06,144,29.94
3810,38,10,355,234,65.92,121,34.08
3811,38,11,363,264,72.73,99,27.27
3812,38,12,363,249,68.6,114,31.4
3813,38,13,448,313,69.87,135,30.13
3814,38,14,420,294,70.0,126,30.0
3815,38,15,366,260,71.04,106,28.96
3816,38,16,390,259,66.41,131,33.59
3817,38,17,468,317,67.74,151,32.26
3818,38,18,413,292,70.7,121,29.3
3819,38,19,429,334,77.86,95,22.14
3820,38,20,404,282,69.8,122,30.2
3821,38,21,399,279,69.92,120,30.08
3822,38,22,367,263,71.66,104,28.34
3823,38,23,414,286,69.08,128,30.92
3824,38,24,391,272,69.57,119,30.43
3825,38,25,366,254,69.4,112,30.6
3826,38,26,409,313,76.53,96,23.47
3827,38,27,398,269,67.59,129,32.41
3828,38,28,481,318,66.11,163,33.89
3829,38,29,411,294,71.53,117,28.47
3830,38,30,391,267,68.29,124,31.71
3831,38,31,411,307,74.7,104,25.3
3832,38,32,389,273,70.18,116,29.82
3833,38,33,340,243,71.47,97,28.53
3834,38,34,366,230,62.84,136,37.16
3835,38,35,374,256,68.45,118,31.55
3836,38,36,379,267,70.45,112,29.55
3837,38,37,389,249,64.01,140,35.99
3838,38,38,393,276,70.23,117,29.77
3839,38,39,432,289,66.9,143,33.1
3840,38,40,408,282,69.12,126,30.88
3841,38,41,358,258,72.07,100,27.93
3901,39,1,398,293,73.62,105,26.38
3902,39,2,255,205,80.39,50,19.61
3903,39,3,471,338,71.76,133,28.24
3904,39,4,405,285,70.37,120,29.63
3905,39,5,429,302,70.4,127,29.6
3906,39,6,442,288,65.16,154,34.84
3907,39,7,375,274,73.07,101,26.93
3908,39,8,426,311,73.0,115,27.0
3909,39,9,373,285,76.41,88,23.59
3910,39,10,197,149,75.63,48,24.37
3911,39,11,399,284,71.18,115,28.82
3912,39,12,563,365,64.83,198,35.17
3913,39,13,346,262,75.72,84,24.28
3914,39,14,428,282,65.89,146,34.11
3915,39,15,480,340,70.83,140,29.17
3916,39,16,381,270,70.87,111,29.13
3917,39,17,420,293,69.76,127,30.24
3918,39,18,416,310,74.52,106,25.48
3919,39,19,400,282,70.5,118,29.5
3920,39,20,519,360,69.36,159,30.64
3921,39,21,415,278,66.99,137,33.01
3922,39,22,422,308,72.99,114,27.01
3923,39,23,418,300,71.77,118,28.23
3924,39,24,512,362,70.7,150,29.3
3925,39,25,348,250,71.84,98,28.16
3926,39,26,370,265,71.62,105,28.38
3927,39,27,61,48,78.69,13,21.31
3928,39,28,525,356,67.81,169,32.19
3929,39,29,223,159,71.3,64,28.7
3930,39,30,525,379,72.19,146,27.81
3931,39,31,368,264,71.74,104,28.26
3932,39,32,312,218,69.87,94,30.13
3933,39,33,425,295,69.41,130,30.59
3934,39,34,492,297,60.37,195,39.63
3935,39,35,417,298,71.46,119,28.54
3936,39,36,104,91,87.5,13,12.5
3937,39,37,366,297,81.15,69,18.85
3938,39,38,214,163,76.17,51,23.83
3939,39,39,259,200,77.22,59,22.78
3940,39,40,431,304,70.53,127,29.47
3941,39,41,422,303,71.8,119,28.2
3942,39,42,439,337,76.77,102,23.23
3943,39,43,424,299,70.52,125,29.48
3944,39,44,325,226,69.54,99,30.46
3945,39,45,361,259,71.75,102,28.25
4001,40,1,430,326,75.81,104,24.19
4002,40,2,491,362,73.73,129,26.27
4003,40,3,610,410,67.21,200,32.79
4004,40,4,295,218,73.9,77,26.1
4005,40,5,549,392,71.4,157,28.6
4006,40,6,580,347,59.83,233,40.17
4007,40,7,463,321,69.33,142,30.67
4008,40,8,640,406,63.44,234,36.56
4009,40,9,375,272,72.53,103,27.47
4010,40,10,525,365,69.52,160,30.48
4011,40,11,495,335,67.68,160,32.32
4012,40,12,410,285,69.51,125,30.49
4013,40,13,722,441,61.08,281,38.92
4014,40,14,434,322,74.19,112,25.81
4015,40,15,458,340,74.24,118,25.76
4016,40,16,645,399,61.86,246,38.14
4017,40,17,406,268,66.01,138,33.99
4018,40,18,388,285,73.45,103,26.55
4019,40,19,590,413,70.0,177,30.0
4020,40,20,500,336,67.2,164,32.8
4021,40,21,550,401,72.91,149,27.09
4022,40,22,601,420,69.88,181,30.12
4023,40,23,594,411,69.19,183,30.81
4024,40,24,455,330,72.53,125,27.47
4025,40,25,572,363,63.46,209,36.54
4026,40,26,514,349,67.9,165,32.1
4027,40,27,589,390,66.21,199,33.79
4028,40,28,516,327,63.37,189,36.63
4029,40,29,497,349,70.22,148,29.78
4030,40,30,408,293,71.81,115,28.19
4031,40,31,552,380,68.84,172,31.16
4032,40,32,534,388,72.66,146,27.34
4033,40,33,473,314,66.38,159,33.62
4034,40,34,414,311,75.12,103,24.88
4035,40,35,324,249,76.85,75,23.15
4036,40,36,400,279,69.75,121,30.25
4037,40,37,497,342,68.81,155,31.19
4038,40,38,613,398,64.93,215,35.07
4039,40,39,184,137,74.46,47,25.54
4101,41,1,424,267,62.97,157,37.03
4102,41,2,469,310,66.1,159,33.9
4103,41,3,425,288,67.76,137,32.24
4104,41,4,417,298,71.46,119,28.54
4105,41,5,512,341,66.6,171,33.4
4106,41,6,490,356,72.65,134,27.35
4107,41,7,446,297,66.59,149,33.41
4108,41,8,430,272,63.26,158,36.74
4109,41,9,393,281,71.5,112,28.5
4110,41,10,431,295,68.45,136,31.55
4111,41,11,460,270,58.7,190,41.3
4112,41,12,468,340,72.65,128,27.35
4113,41,13,477,315,66.04,162,33.96
4114,41,14,461,322,69.85,139,30.15
4115,41,15,526,374,71.1,152,28.9
4116,41,16,410,273,66.59,137,33.41
4117,41,17,383,254,66.32,129,33.68
4118,41,18,387,256,66.15,131,33.85
4119,41,19,453,354,78.15,99,21.85
4120,41,20,325,210,64.62,115,35.38
4121,41,21,462,321,69.48,141,30.52
4122,41,22,495,330,66.67,165,33.33
4123,41,23,416,286,68.75,130,31.25
4124,41,24,409,279,68.22,130,31.78
4125,41,25,387,259,66.93,128,33.07
4126,41,26,393,271,68.96,122,31.04
4127,41,27,379,260,68.6,119,31.4
4128,41,28,416,283,68.03,133,31.97
4129,41,29,342,237,69.3,105,30.7
4130,41,30,377,257,68.17,120,31.83
4131,41,31,382,273,71.47,109,28.53
4132,41,32,385,267,69.35,118,30.65
4133,41,33,416,292,70.19,124,29.81
4134,41,34,399,269,67.42,130,32.58
4135,41,35,497,331,66.6,166,33.4
4136,41,36,437,272,62.24,165,37.76
4137,41,37,485,354,72.99,131,27.01
4138,41,38,415,264,63.61,151,36.39
4139,41,39,440,282,64.09,158,35.91
4140,41,40,480,292,60.83,188,39.17
4141,41,41,457,313,68.49,144,31.51
4142,41,42,429,290,67.6,139,32.4
4143,41,43,415,281,67.71,134,32.29
4144,41,44,432,273,63.19,159,36.81
4145,41,45,436,301,69.04,135,30.96
4146,41,46,426,280,65.73,146,34.27
4147,41,47,424,298,70.28,126,29.72
4201,42,1,405,343,84.69,62,15.31
4202,42,2,602,462,76.74,140,23.26
4203,42,3,515,404,78.45,111,21.55
4204,42,4,1120,890,79.46,230,20.54
4205,42,5,396,323,81.57,73,18.43
4206,42,6,455,363,79.78,92,20.22
4207,42,7,573,460,80.28,113,19.72
4208,42,8,378,270,71.43,108,28.57
4209,42,9,679,523,77.03,156,22.97
4210,42,10,706,534,75.64,172,24.36
4211,42,11,316,265,83.86,51,16.14
4212,42,12,397,322,81.11,75,18.89
4213,42,13,376,299,79.52,77,20.48
4214,42,14,669,540,80.72,129,19.28
4215,42,15,657,513,78.08,144,21.92
4216,42,16,502,368,73.31,134,26.69
4217,42,17,785,611,77.83,174,22.17
4218,42,18,643,504,78.38,139,21.62
4219,42,19,600,483,80.5,117,19.5
4220,42,20,597,455,76.21,142,23.79
4221,42,21,625,504,80.64,121,19.36
4222,42,22,282,219,77.66,63,22.34
4223,42,23,507,394,77.71,113,22.29
4224,42,24,432,344,79.63,88,20.37
4225,42,25,568,440,77.46,128,22.54
4226,42,26,793,635,80.08,158,19.92
4227,42,27,340,242,71.18,98,28.82
4228,42,28,531,413,77.78,118,22.22
4229,42,29,591,456,77.16,135,22.84
4230,42,30,371,310,83.56,61,16.44
4231,42,31,563,444,78.86,119,21.14
4232,42,32,597,462,77.39,135,22.61
4233,42,33,571,429,75.13,142,24.87
4234,42,34,381,296,77.69,85,22.31
4235,42,35,607,472,77.76,135,22.24
4236,42,36,903,661,73.2,242,26.8
4237,42,37,383,282,73.63,101,26.37
4238,42,38,490,384,78.37,106,21.63
4239,42,39,871,688,78.99,183,21.01
4240,42,40,739,585,79.16,154,20.84
4241,42,41,522,395,75.67,127,24.33
4242,42,42,891,728,81.71,163,18.29
4301,43,1,252,196,77.78,56,22.22
4302,43,2,526,414,78.71,112,21.29
4303,43,3,456,349,76.54,107,23.46
4304,43,4,560,446,79.64,114,20.36
4305,43,5,448,357,79.69,91,20.31
4306,43,6,384,302,78.65,82,21.35
4307,43,7,287,231,80.49,56,19.51
4308,43,8,371,299,80.59,72,19.41
4309,43,9,470,368,78.3,102,21.7
4310,43,10,581,462,79.52,119,20.48
4311,43,11,459,351,76.47,108,23.53
4312,43,12,318,241,75.79,77,24.21
4313,43,13,489,364,74.44,125,25.56
4314,43,14,499,400,80.16,99,19.84
4315,43,15,465,342,73.55,123,26.45
4316,43,16,654,495,75.69,159,24.31
4317,43,17,391,329,84.14,62,15.86
4318,43,18,540,433,80.19,107,19.81
4319,43,19,472,381,80.72,91,19.28
4320,43,20,587,470,80.07,117,19.93
4321,43,21,557,416,74.69,141,25.31
4322,43,22,340,259,76.18,81,23.82
4323,43,23,344,261,75.87,83,24.13
4324,43,24,357,274,76.75,83,23.25
4325,43,25,397,309,77.83,88,22.17
4326,43,26,292,246,84.25,46,15.75
4327,43,27,452,361,79.87,91,20.13
4328,43,28,583,482,82.68,101,17.32
4329,43,29,674,544,80.71,130,19.29
4330,43,30,519,401,77.26,118,22.74
4331,43,31,457,364,79.65,93,20.35
4332,43,32,498,403,80.92,95,19.08
4333,43,33,450,379,84.22,71,15.78
4334,43,34,320,258,80.63,62,19.38
4335,43,35,494,388,78.54,106,21.46
4336,43,36,322,247,76.71,75,23.29
4337,43,37,576,441,76.56,135,23.44
4338,43,38,324,264,81.48,60,18.52
4339,43,39,361,264,73.13,97,26.87
4340,43,40,369,274,74.25,95,25.75
4341,43,41,593,469,79.09,124,20.91
4342,43,42,458,348,75.98,110,24.02
4343,43,43,460,387,84.13,73,15.87
4344,43,44,464,358,77.16,106,22.84
4345,43,45,300,230,76.67,70,23.33
4346,43,46,292,227,77.74,65,22.26
4401,44,1,815,616,75.58,199,24.42
4402,44,2,528,416,78.79,112,21.21
4403,44,3,276,238,86.23,38,13.77
4404,44,4,395,325,82.28,70,17.72
4405,44,5,533,409,76.74,124,23.26
4406,44,6,656,480,73.17,176,26.83
4407,44,7,319,254,79.62,65,20.38
4408,44,8,731,550,75.24,181,24.76
4409,44,9,558,424,75.99,134,24.01
4410,44,10,571,423,74.08,148,25.92
4411,44,11,622,443,71.22,179,28.78
4412,44,12,556,430,77.34,126,22.66
4413,44,13,474,368,77.64,106,22.36
4414,44,14,529,390,73.72,139,26.28
4415,44,15,499,375,75.15,124,24.85
4416,44,16,634,448,70.66,186,29.34
4417,44,17,718,529,73.68,189,26.32
4418,44,18,580,431,74.31,149,25.69
4419,44,19,630,483,76.67,147,23.33
4420,44,20,684,485,70.91,199,29.09
4421,44,21,627,471,75.12,156,24.88
4422,44,22,511,403,78.86,108,21.14
4423,44,23,522,408,78.16,114,21.84
4424,44,24,348,297,85.34,51,14.66
4425,44,25,544,429,78.86,115,21.14
4426,44,26,721,501,69.49,220,30.51
4427,44,27,621,460,74.07,161,25.93
4428,44,28,594,452,76.09,142,23.91
4429,44,29,624,467,74.84,157,25.16
4430,44,30,652,473,72.55,179,27.45
4431,44,31,500,355,71.0,145,29.0
4432,44,32,634,445,70.19,189,29.81
4433,44,33,615,459,74.63,156,25.37
4434,44,34,555,443,79.82,112,20.18
4435,44,35,548,429,78.28,119,21.72
4436,44,36,640,497,77.66,143,22.34
4437,44,37,627,455,72.57,172,27.43
4438,44,38,659,480,72.84,179,27.16
4439,44,39,595,466,78.32,129,21.68
4440,44,40,526,405,77.0,121,23.0
4441,44,41,707,533,75.39,174,24.61
4501,45,1,368,247,67.12,121,32.88
4502,45,2,452,299,66.15,153,33.85
4503,45,3,397,283,71.28,114,28.72
4504,45,4,520,343,65.96,177,34.04
4505,45,5,455,332,72.97,123,27.03
4506,45,6,597,401,67.17,196,32.83
4507,45,7,622,484,77.81,138,22.19
4508,45,8,454,320,70.48,134,29.52
4509,45,9,436,284,65.14,152,34.86
4510,45,10,427,291,68.15,136,31.85
4511,45,11,346,245,70.81,101,29.19
4512,45,12,392,272,69.39,120,30.61
4513,45,13,357,256,71.71,101,28.29
4514,45,14,614,439,71.5,175,28.5
4515,45,15,525,372,70.86,153,29.14
4516,45,16,359,244,67.97,115,32.03
4517,45,17,457,320,70.02,137,29.98
4518,45,18,466,318,68.24,148,31.76
4519,45,19,236,164,69.49,72,30.51
4520,45,20,296,211,71.28,85,28.72
4521,45,21,372,239,64.25,133,35.75
4522,45,22,395,283,71.65,112,28.35
4523,45,23,399,274,68.67,125,31.33
4524,45,24,342,234,68.42,108,31.58
4525,45,25,280,199,71.07,81,28.93
4526,45,26,240,179,74.58,61,25.42
4527,45,27,412,284,68.93,128,31.07
4528,45,28,351,248,70.66,103,29.34
4529,45,29,273,202,73.99,71,26.01
4530,45,30,426,296,69.48,130,30.52
4531,45,31,337,239,70.92,98,29.08
4532,45,32,401,274,68.33,127,31.67
4533,45,33,304,207,68.09,97,31.91
4534,45,34,448,316,70.54,132,29.46
4535,45,35,467,324,69.38,143,30.62
4536,45,36,435,301,69.2,134,30.8
4537,45,37,401,271,67.58,130,32.42
4538,45,38,406,279,68.72,127,31.28
4539,45,39,423,293,69.27,130,30.73
4540,45,40,399,268,67.17,131,32.83
4541,45,41,378,254,67.2,124,32.8
4542,45,42,398,279,70.1,119,29.9
4543,45,43,445,308,69.21,137,30.79
4544,45,44,390,259,66.41,131,33.59
4545,45,45,276,177,64.13,99,35.87
4546,45,46,342,212,61.99,130,38.01
4547,45,47,304,211,69.41,93,30.59
4548,45,48,325,213,65.54,112,34.46
4601,46,1,399,260,65.16,139,34.84
4602,46,2,510,339,66.47,171,33.53
4603,46,3,579,459,79.27,120,20.73
4604,46,4,499,341,68.34,158,31.66
4605,46,5,682,481,70.53,201,29.47
4606,46,6,447,296,66.22,151,33.78
4607,46,7,477,375,78.62,102,21.38
4608,46,8,351,228,64.96,123,35.04
4609,46,9,589,410,69.61,179,30.39
4610,46,10,885,652,73.67,233,26.33
4611,46,11,490,337,68.78,153,31.22
4612,46,12,567,357,62.96,210,37.04
4613,46,13,539,405,75.14,134,24.86
4614,46,14,524,377,71.95,147,28.05
4615,46,15,520,379,72.88,141,27.12
4616,46,16,602,407,67.61,195,32.39
4617,46,17,551,423,76.77,128,23.23
4618,46,18,580,425,73.28,155,26.72
4619,46,19,343,260,75.8,83,24.2
4620,46,20,439,320,72.89,119,27.11
4621,46,21,396,266,67.17,130,32.83
4622,46,22,367,251,68.39,116,31.61
4623,46,23,485,342,70.52,143,29.48
4624,46,24,643,484,75.27,159,24.73
4625,46,25,520,341,65.58,179,34.42
4626,46,26,718,483,67.27,235,32.73
4627,46,27,682,461,67.6,221,32.4
4628,46,28,471,374,79.41,97,20.59
4629,46,29,414,331,79.95,83,20.05
4630,46,30,529,384,72.59,145,27.41
4631,46,31,536,398,74.25,138,25.75
4632,46,32,484,321,66.32,163,33.68
4633,46,33,524,400,76.34,124,23.66
4634,46,34,670,467,69.7,203,30.3
4635,46,35,587,427,72.74,160,27.26
4636,46,36,487,379,77.82,108,22.18
4637,46,37,414,299,72.22,115,27.78
4638,46,38,596,436,73.15,160,26.85
4639,46,39,473,322,68.08,151,31.92
4640,46,40,442,324,73.3,118,26.7
4701,47,1,378,236,62.43,142,37.57
4702,47,2,534,372,69.66,162,30.34
4703,47,3,498,371,74.5,127,25.5
4704,47,4,640,434,67.81,206,32.19
4705,47,5,598,348,58.19,250,41.81
4706,47,6,661,451,68.23,210,31.77
4707,47,7,507,319,62.92,188,37.08
4708,47,8,544,337,61.95,207,38.05
4709,47,9,507,341,67.26,166,32.74
4710,47,10,669,371,55.46,298,44.54
4711,47,11,545,396,72.66,149,27.34
4712,47,12,603,373,61.86,230,38.14
4713,47,13,540,325,60.19,215,39.81
4714,47,14,504,336,66.67,168,33.33
4715,47,15,703,337,47.94,366,52.06
4716,47,16,549,389,70.86,160,29.14
4717,47,17,540,331,61.3,209,38.7
4718,47,18,527,327,62.05,200,37.95
4719,47,19,859,507,59.02,352,40.98
4720,47,20,580,336,57.93,244,42.07
4721,47,21,520,311,59.81,209,40.19
4722,47,22,597,350,58.63,247,41.37
4723,47,23,628,370,58.92,258,41.08
4724,47,24,558,365,65.41,193,34.59
4725,47,25,680,402,59.12,278,40.88
4726,47,26,756,456,60.32,300,39.68
4727,47,27,475,292,61.47,183,38.53
4728,47,28,510,338,66.27,172,33.73
4729,47,29,644,432,67.08,212,32.92
4730,47,30,692,462,66.76,230,33.24
4731,47,31,594,376,63.3,218,36.7
4732,47,32,677,426,62.92,251,37.08
4733,47,33,517,358,69.25,159,30.75
4734,47,34,572,377,65.91,195,34.09
4735,47,35,543,361,66.48,182,33.52
4736,47,36,640,371,57.97,269,42.03
4737,47,37,506,294,58.1,212,41.9
4738,47,38,553,332,60.04,221,39.96
4739,47,39,554,308,55.6,246,44.4
4740,47,40,510,327,64.12,183,35.88
4741,47,41,612,387,63.24,225,36.76
4742,47,42,542,293,54.06,249,45.94
4743,47,43,498,352,70.68,146,29.32
4744,47,44,456,330,72.37,126,27.63
4745,47,45,519,288,55.49,231,44.51
4746,47,46,562,348,61.92,214,38.08
4747,47,47,670,440,65.67,230,34.33
4748,47,48,35,26,74.29,9,25.71
4801,48,1,517,336,64.99,181,35.01
4802,48,2,216,168,77.78,48,22.22
4803,48,3,587,413,70.36,174,29.64
4804,48,4,457,322,70.46,135,29.54
4805,48,5,250,185,74.0,65,26.0
4806,48,6,596,413,69.3,183,30.7
4807,48,7,545,391,71.74,154,28.26
4808,48,8,250,196,78.4,54,21.6
4809,48,9,324,254,78.4,70,21.6
4810,48,10,719,476,66.2,243,33.8
4811,48,11,408,276,67.65,132,32.35
4812,48,12,590,397,67.29,193,32.71
4813,48,13,620,481,77.58,139,22.42
4814,48,14,200,155,77.5,45,22.5
4815,48,15,331,241,72.81,90,27.19
4816,48,16,549,365,66.48,184,33.52
4817,48,17,429,324,75.52,105,24.48
4818,48,18,330,245,74.24,85,25.76
4819,48,19,357,254,71.15,103,28.85
4820,48,20,558,341,61.11,217,38.89
4821,48,21,647,431,66.62,216,33.38
4822,48,22,380,314,82.63,66,17.37
4823,48,23,436,345,79.13,91,20.87
4824,48,24,581,385,66.27,196,33.73
4825,48,25,439,291,66.29,148,33.71
4826,48,26,245,175,71.43,70,28.57
4827,48,27,498,342,68.67,156,31.33
4828,48,28,519,372,71.68,147,28.32
4829,48,29,183,163,89.07,20,10.93
4830,48,30,436,281,64.45,155,35.55
4831,48,31,723,475,65.7,248,34.3
4832,48,32,543,387,71.27,156,28.73
4833,48,33,260,211,81.15,49,18.85
4834,48,34,428,301,70.33,127,29.67
4835,48,35,289,189,65.4,100,34.6
4836,48,36,274,222,81.02,52,18.98
4837,48,37,532,334,62.78,198,37.22
4838,48,38,510,388,76.08,122,23.92
4839,48,39,369,283,76.69,86,23.31
4840,48,40,460,323,70.22,137,29.78
4841,48,41,664,396,59.64,268,40.36
4842,48,42,598,371,62.04,227,37.96
4843,48,43,596,423,70.97,173,29.03
4844,48,44,648,419,64.66,229,35.34
4845,48,45,386,253,65.54,133,34.46
4846,48,46,280,206,73.57,74,26.43
4901,49,1,339,219,64.6,120,35.4
4902,49,2,321,219,68.22,102,31.78
4903,49,3,638,446,69.91,192,30.09
4904,49,4,706,448,63.46,258,36.54
4905,49,5,491,335,68.23,156,31.77
4906,49,6,442,312,70.59,130,29.41
4907,49,7,409,297,72.62,112,27.38
4908,49,8,454,349,76.87,105,23.13
4909,49,9,521,341,65.45,180,34.55
4910,49,10,596,402,67.45,194,32.55
4911,49,11,686,458,66.76,228,33.24
4912,49,12,647,449,69.4,198,30.6
4913,49,13,578,383,66.26,195,33.74
4914,49,14,398,269,67.59,129,32.41
4915,49,15,379,262,69.13,117,30.87
4916,49,16,460,323,70.22,137,29.78
4917,49,17,395,292,73.92,103,26.08
4918,49,18,668,423,63.32,245,36.68
4919,49,19,472,324,68.64,148,31.36
4920,49,20,783,508,64.88,275,35.12
4921,49,21,312,220,70.51,92,29.49
4922,49,22,544,366,67.28,178,32.72
4923,49,23,684,424,61.99,260,38.01
4924,49,24,395,292,73.92,103,26.08
4925,49,25,648,433,66.82,215,33.18
4926,49,26,588,378,64.29,210,35.71
4927,49,27,598,403,67.39,195,32.61
4928,49,28,744,467,62.77,277,37.23
4929,49,29,604,380,62.91,224,37.09
4930,49,30,544,371,68.2,173,31.8
4931,49,31,349,238,68.19,111,31.81
4932,49,32,494,297,60.12,197,39.88
4933,49,33,396,267,67.42,129,32.58
5001,50,1,322,244,75.78,78,24.22
5002,50,2,213,157,73.71,56,26.29
5003,50,3,296,225,76.01,71,23.99
5004,50,4,406,311,76.6,95,23.4
5005,50,5,206,160,77.67,46,22.33
5006,50,6,392,289,73.72,103,26.28
5007,50,7,495,369,74.55,126,25.45
5008,50,8,372,251,67.47,121,32.53
5009,50,9,305,217,71.15,88,28.85
5010,50,10,383,275,71.8,108,28.2
5011,50,11,180,123,68.33,57,31.67
5012,50,12,145,103,71.03,42,28.97
5013,50,13,467,351,75.16,116,24.84
5014,50,14,106,79,74.53,27,25.47
5015,50,15,484,362,74.79,122,25.21
5016,50,16,101,70,69.31,31,30.69
5017,50,17,378,283,74.87,95,25.13
5018,50,18,44,29,65.91,15,34.09
5019,50,19,326,243,74.54,83,25.46
5020,50,20,427,309,72.37,118,27.63
5021,50,21,347,273,78.67,74,21.33
5022,50,22,330,244,73.94,86,26.06
5023,50,23,258,186,72.09,72,27.91
5024,50,24,219,149,68.04,70,31.96
5025,50,25,295,200,67.8,95,32.2
5026,50,26,402,281,69.9,121,30.1
5027,50,27,99,68,68.69,31,31.31
5028,50,28,411,288,70.07,123,29.93
5029,50,29,401,286,71.32,115,28.68
5030,50,30,315,246,78.1,69,21.9
5031,50,31,545,399,73.21,146,26.79
5032,50,32,441,330,74.83,111,25.17
5033,50,33,226,159,70.35,67,29.65
5034,50,34,462,347,75.11,115,24.89
5035,50,35,539,414,76.81,125,23.19
5036,50,36,386,271,70.21,115,29.79
5037,50,37,400,298,74.5,102,25.5
5038,50,38,115,84,73.04,31,26.96
5039,50,39,221,151,68.33,70,31.67
5040,50,40,238,150,63.03,88,36.97
