id,ward,precinct,total,Yes,Yes Percent,No,No Percent
0101,1,1,503,362,71.97,141,28.03
0102,1,2,461,320,69.41,141,30.59
0103,1,3,587,486,82.79,101,17.21
0104,1,4,567,442,77.95,125,22.05
0105,1,5,507,410,80.87,97,19.13
0106,1,6,432,337,78.01,95,21.99
0107,1,7,362,298,82.32,64,17.68
0108,1,8,424,336,79.25,88,20.75
0109,1,9,359,281,78.27,78,21.73
0110,1,10,615,487,79.19,128,20.81
0111,1,11,568,472,83.1,96,16.9
0112,1,12,588,436,74.15,152,25.85
0113,1,13,248,187,75.4,61,24.6
0114,1,14,455,357,78.46,98,21.54
0115,1,15,467,350,74.95,117,25.05
0116,1,16,549,411,74.86,138,25.14
0117,1,17,423,302,71.39,121,28.61
0118,1,18,487,355,72.9,132,27.1
0119,1,19,588,435,73.98,153,26.02
0120,1,20,402,304,75.62,98,24.38
0121,1,21,664,546,82.23,118,17.77
0122,1,22,327,242,74.01,85,25.99
0123,1,23,648,500,77.16,148,22.84
0124,1,24,446,305,68.39,141,31.61
0125,1,25,493,378,76.67,115,23.33
0126,1,26,334,236,70.66,98,29.34
0127,1,27,558,447,80.11,111,19.89
0128,1,28,167,121,72.46,46,27.54
0129,1,29,620,499,80.48,121,19.52
0130,1,30,566,397,70.14,169,29.86
0131,1,31,445,347,77.98,98,22.02
0132,1,32,474,370,78.06,104,21.94
0133,1,33,525,410,78.1,115,21.9
0134,1,34,411,320,77.86,91,22.14
0135,1,35,618,463,74.92,155,25.08
0136,1,36,576,472,81.94,104,18.06
0137,1,37,492,395,80.28,97,19.72
0138,1,38,479,365,76.2,114,23.8
0139,1,39,419,332,79.24,87,20.76
0140,1,40,434,339,78.11,95,21.89
0141,1,41,279,215,77.06,64,22.94
0142,1,42,176,133,75.57,43,24.43
0143,1,43,319,248,77.74,71,22.26
0144,1,44,456,340,74.56,116,25.44
0201,2,1,546,424,77.66,122,22.34
0202,2,2,338,283,83.73,55,16.27
0203,2,3,556,434,78.06,122,21.94
0204,2,4,486,384,79.01,102,20.99
0205,2,5,611,478,78.23,133,21.77
0206,2,6,526,403,76.62,123,23.38
0207,2,7,441,361,81.86,80,18.14
0208,2,8,621,490,78.9,131,21.1
0209,2,9,455,384,84.4,71,15.6
0210,2,10,328,268,81.71,60,18.29
0211,2,11,449,372,82.85,77,17.15
0212,2,12,376,317,84.31,59,15.69
0213,2,13,371,309,83.29,62,16.71
0214,2,14,487,399,81.93,88,18.07
0215,2,15,423,332,78.49,91,21.51
0216,2,16,481,395,82.12,86,17.88
0217,2,17,569,431,75.75,138,24.25
0218,2,18,411,356,86.62,55,13.38
0219,2,19,292,235,80.48,57,19.52
0220,2,20,576,481,83.51,95,16.49
0221,2,21,513,405,78.95,108,21.05
0222,2,22,454,383,84.36,71,15.64
0223,2,23,288,247,85.76,41,14.24
0224,2,24,405,348,85.93,57,14.07
0225,2,25,532,438,82.33,94,17.67
0226,2,26,379,307,81.0,72,19.0
0227,2,27,398,316,79.4,82,20.6
0228,2,28,517,443,85.69,74,14.31
0229,2,29,497,396,79.68,101,20.32
0230,2,30,405,338,83.46,67,16.54
0231,2,31,516,440,85.27,76,14.73
0232,2,32,414,332,80.19,82,19.81
0233,2,33,630,530,84.13,100,15.87
0234,2,34,319,278,87.15,41,12.85
0235,2,35,597,504,84.42,93,15.58
0236,2,36,469,392,83.58,77,16.42
0237,2,37,403,331,82.13,72,17.87
0238,2,38,400,326,81.5,74,18.5
0239,2,39,318,252,79.25,66,20.75
0240,2,40,634,522,82.33,112,17.67
0241,2,41,544,440,80.88,104,19.12
0242,2,42,518,432,83.4,86,16.6
0243,2,43,608,510,83.88,98,16.12
0244,2,44,286,239,83.57,47,16.43
0245,2,45,540,450,83.33,90,16.67
0246,2,46,246,190,77.24,56,22.76
0301,3,1,626,457,73.0,169,27.0
0302,3,2,458,367,80.13,91,19.87
0303,3,3,371,275,74.12,96,25.88
0304,3,4,531,409,77.02,122,22.98
0305,3,5,268,199,74.25,69,25.75
0306,3,6,648,500,77.16,148,22.84
0307,3,7,252,200,79.37,52,20.63
0308,3,8,355,242,68.17,113,31.83
0309,3,9,524,375,71.56,149,28.44
0310,3,10,209,151,72.25,58,27.75
0311,3,11,526,391,74.33,135,25.67
0312,3,12,411,313,76.16,98,23.84
0313,3,13,530,429,80.94,101,19.06
0314,3,14,531,430,80.98,101,19.02
0315,3,15,433,310,71.59,123,28.41
0316,3,16,384,280,72.92,104,27.08
0317,3,17,672,523,77.83,149,22.17
0318,3,18,601,444,73.88,157,26.12
0319,3,19,564,462,81.91,102,18.09
0320,3,20,500,366,73.2,134,26.8
0321,3,21,486,415,85.39,71,14.61
0322,3,22,655,501,76.49,154,23.51
0323,3,23,379,278,73.35,101,26.65
0324,3,24,404,299,74.01,105,25.99
0325,3,25,783,647,82.63,136,17.37
0326,3,26,498,416,83.53,82,16.47
0327,3,27,600,487,81.17,113,18.83
0328,3,28,217,152,70.05,65,29.95
0329,3,29,476,326,68.49,150,31.51
0330,3,30,392,288,73.47,104,26.53
0331,3,31,528,378,71.59,150,28.41
0332,3,32,742,607,81.81,135,18.19
0333,3,33,583,470,80.62,113,19.38
0334,3,34,690,539,78.12,151,21.88
0335,3,35,249,189,75.9,60,24.1
0336,3,36,219,151,68.95,68,31.05
0337,3,37,451,308,68.29,143,31.71
0338,3,38,327,260,79.51,67,20.49
0339,3,39,929,772,83.1,157,16.9
0340,3,40,493,368,74.65,125,25.35
0341,3,41,320,250,78.13,70,21.88
0401,4,1,697,537,77.04,160,22.96
0402,4,2,646,531,82.2,115,17.8
0403,4,3,388,286,73.71,102,26.29
0404,4,4,637,475,74.57,162,25.43
0405,4,5,502,367,73.11,135,26.89
0406,4,6,508,401,78.94,107,21.06
0407,4,7,621,491,79.07,130,20.93
0408,4,8,526,390,74.14,136,25.86
0409,4,9,512,426,83.2,86,16.8
0410,4,10,624,480,76.92,144,23.08
0411,4,11,475,358,75.37,117,24.63
0412,4,12,647,483,74.65,164,25.35
0413,4,13,630,517,82.06,113,17.94
0414,4,14,480,372,77.5,108,22.5
0415,4,15,554,427,77.08,127,22.92
0416,4,16,844,692,81.99,152,18.01
0417,4,17,563,462,82.06,101,17.94
0418,4,18,460,351,76.3,109,23.7
0419,4,19,313,206,65.81,107,34.19
0420,4,20,369,298,80.76,71,19.24
0421,4,21,542,416,76.75,126,23.25
0422,4,22,435,352,80.92,83,19.08
0423,4,23,582,474,81.44,108,18.56
0424,4,24,454,355,78.19,99,21.81
0425,4,25,598,469,78.43,129,21.57
0426,4,26,428,327,76.4,101,23.6
0427,4,27,639,492,77.0,147,23.0
0428,4,28,439,326,74.26,113,25.74
0429,4,29,469,363,77.4,106,22.6
0430,4,30,665,494,74.29,171,25.71
0431,4,31,401,334,83.29,67,16.71
0432,4,32,542,422,77.86,120,22.14
0433,4,33,457,362,79.21,95,20.79
0434,4,34,433,329,75.98,104,24.02
0435,4,35,574,444,77.35,130,22.65
0436,4,36,587,461,78.53,126,21.47
0437,4,37,915,772,84.37,143,15.63
0438,4,38,535,416,77.76,119,22.24
0501,5,1,428,305,71.26,123,28.74
0502,5,2,343,253,73.76,90,26.24
0503,5,3,439,375,85.42,64,14.58
0504,5,4,584,446,76.37,138,23.63
0505,5,5,393,289,73.54,104,26.46
0506,5,6,347,258,74.35,89,25.65
0507,5,7,418,307,73.44,111,26.56
0508,5,8,425,372,87.53,53,12.47
0509,5,9,514,411,79.96,103,20.04
0510,5,10,366,260,71.04,106,28.96
0511,5,11,433,352,81.29,81,18.71
0512,5,12,283,200,70.67,83,29.33
0513,5,13,398,271,68.09,127,31.91
0514,5,14,362,284,78.45,78,21.55
0515,5,15,414,323,78.02,91,21.98
0516,5,16,433,297,68.59,136,31.41
0517,5,17,357,269,75.35,88,24.65
0518,5,18,406,311,76.6,95,23.4
0519,5,19,413,335,81.11,78,18.89
0520,5,20,472,387,81.99,85,18.01
0521,5,21,443,360,81.26,83,18.74
0522,5,22,515,418,81.17,97,18.83
0523,5,23,774,622,80.36,152,19.64
0524,5,24,562,430,76.51,132,23.49
0525,5,25,383,319,83.29,64,16.71
0526,5,26,446,334,74.89,112,25.11
0527,5,27,391,341,87.21,50,12.79
0528,5,28,449,339,75.5,110,24.5
0529,5,29,463,337,72.79,126,27.21
0530,5,30,288,192,66.67,96,33.33
0531,5,31,340,256,75.29,84,24.71
0532,5,32,488,385,78.89,103,21.11
0533,5,33,413,306,74.09,107,25.91
0534,5,34,430,365,84.88,65,15.12
0535,5,35,541,449,82.99,92,17.01
0536,5,36,257,199,77.43,58,22.57
0537,5,37,451,388,86.03,63,13.97
0538,5,38,408,295,72.3,113,27.7
0539,5,39,359,310,86.35,49,13.65
0540,5,40,350,249,71.14,101,28.86
0541,5,41,186,161,86.56,25,13.44
0601,6,1,373,289,77.48,84,22.52
0602,6,2,373,285,76.41,88,23.59
0603,6,3,352,279,79.26,73,20.74
0604,6,4,264,190,71.97,74,28.03
0605,6,5,239,174,72.8,65,27.2
0606,6,6,430,313,72.79,117,27.21
0607,6,7,366,252,68.85,114,31.15
0608,6,8,356,272,76.4,84,23.6
0609,6,9,386,285,73.83,101,26.17
0610,6,10,251,169,67.33,82,32.67
0611,6,11,320,243,75.94,77,24.06
0612,6,12,269,191,71.0,78,29.0
0613,6,13,273,197,72.16,76,27.84
0614,6,14,329,237,72.04,92,27.96
0615,6,15,312,213,68.27,99,31.73
0616,6,16,383,284,74.15,99,25.85
0617,6,17,239,169,70.71,70,29.29
0618,6,18,266,205,77.07,61,22.93
0619,6,19,297,211,71.04,86,28.96
0620,6,20,238,185,77.73,53,22.27
0621,6,21,169,119,70.41,50,29.59
0622,6,22,204,156,76.47,48,23.53
0623,6,23,165,117,70.91,48,29.09
0624,6,24,189,126,66.67,63,33.33
0625,6,25,188,131,69.68,57,30.32
0626,6,26,255,188,73.73,67,26.27
0627,6,27,215,160,74.42,55,25.58
0628,6,28,172,122,70.93,50,29.07
0629,6,29,348,274,78.74,74,21.26
0630,6,30,310,218,70.32,92,29.68
0631,6,31,313,262,83.71,51,16.29
0632,6,32,375,277,73.87,98,26.13
0633,6,33,373,276,73.99,97,26.01
0634,6,34,363,257,70.8,106,29.2
0635,6,35,329,242,73.56,87,26.44
0636,6,36,393,303,77.1,90,22.9
0637,6,37,414,318,76.81,96,23.19
0638,6,38,386,280,72.54,106,27.46
0639,6,39,300,213,71.0,87,29.0
0640,6,40,309,223,72.17,86,27.83
0641,6,41,365,270,73.97,95,26.03
0642,6,42,343,248,72.3,95,27.7
0643,6,43,334,244,73.05,90,26.95
0644,6,44,385,288,74.81,97,25.19
0645,6,45,368,263,71.47,105,28.53
0646,6,46,277,199,71.84,78,28.16
0647,6,47,244,184,75.41,60,24.59
0648,6,48,352,273,77.56,79,22.44
0701,7,1,341,241,70.67,100,29.33
0702,7,2,335,233,69.55,102,30.45
0703,7,3,331,241,72.81,90,27.19
0704,7,4,339,267,78.76,72,21.24
0705,7,5,304,227,74.67,77,25.33
0706,7,6,429,311,72.49,118,27.51
0707,7,7,346,245,70.81,101,29.19
0708,7,8,205,145,70.73,60,29.27
0709,7,9,595,435,73.11,160,26.89
0710,7,10,344,271,78.78,73,21.22
0711,7,11,380,256,67.37,124,32.63
0712,7,12,315,219,69.52,96,30.48
0713,7,13,204,145,71.08,59,28.92
0714,7,14,395,288,72.91,107,27.09
0715,7,15,320,245,76.56,75,23.44
0716,7,16,336,228,67.86,108,32.14
0717,7,17,279,195,69.89,84,30.11
0718,7,18,307,216,70.36,91,29.64
0719,7,19,335,251,74.93,84,25.07
0720,7,20,276,196,71.01,80,28.99
0721,7,21,269,172,63.94,97,36.06
0722,7,22,299,203,67.89,96,32.11
0723,7,23,314,235,74.84,79,25.16
0724,7,24,280,205,73.21,75,26.79
0725,7,25,287,208,72.47,79,27.53
0726,7,26,264,192,72.73,72,27.27
0727,7,27,264,214,81.06,50,18.94
0728,7,28,250,163,65.2,87,34.8
0729,7,29,326,245,75.15,81,24.85
0730,7,30,273,213,78.02,60,21.98
0731,7,31,249,182,73.09,67,26.91
0732,7,32,431,325,75.41,106,24.59
0733,7,33,407,318,78.13,89,21.87
0734,7,34,425,318,74.82,107,25.18
0735,7,35,380,267,70.26,113,29.74
0736,7,36,439,323,73.58,116,26.42
0737,7,37,348,270,77.59,78,22.41
0738,7,38,310,233,75.16,77,24.84
0739,7,39,319,231,72.41,88,27.59
0740,7,40,282,218,77.3,64,22.7
0741,7,41,333,255,76.58,78,23.42
0742,7,42,341,268,78.59,73,21.41
0743,7,43,324,258,79.63,66,20.37
0744,7,44,302,230,76.16,72,23.84
0745,7,45,324,224,69.14,100,30.86
0746,7,46,89,74,83.15,15,16.85
0801,8,1,325,239,73.54,86,26.46
0802,8,2,339,244,71.98,95,28.02
0803,8,3,376,295,78.46,81,21.54
0804,8,4,399,312,78.2,87,21.8
0805,8,5,299,245,81.94,54,18.06
0806,8,6,352,276,78.41,76,21.59
0807,8,7,400,312,78.0,88,22.0
0808,8,8,361,283,78.39,78,21.61
0809,8,9,228,176,77.19,52,22.81
0810,8,10,450,345,76.67,105,23.33
0811,8,11,296,210,70.95,86,29.05
0812,8,12,308,230,74.68,78,25.32
0813,8,13,412,300,72.82,112,27.18
0814,8,14,291,191,65.64,100,34.36
0815,8,15,227,185,81.5,42,18.5
0816,8,16,105,81,77.14,24,22.86
0817,8,17,289,227,78.55,62,21.45
0818,8,18,318,231,72.64,87,27.36
0819,8,19,390,304,77.95,86,22.05
0820,8,20,408,289,70.83,119,29.17
0821,8,21,446,331,74.22,115,25.78
0822,8,22,329,243,73.86,86,26.14
0823,8,23,280,213,76.07,67,23.93
0824,8,24,187,140,74.87,47,25.13
0825,8,25,349,240,68.77,109,31.23
0826,8,26,295,208,70.51,87,29.49
0827,8,27,390,303,77.69,87,22.31
0828,8,28,361,289,80.06,72,19.94
0829,8,29,358,268,74.86,90,25.14
0830,8,30,391,303,77.49,88,22.51
0831,8,31,281,203,72.24,78,27.76
0832,8,32,280,211,75.36,69,24.64
0833,8,33,266,181,68.05,85,31.95
0834,8,34,326,264,80.98,62,19.02
0835,8,35,401,307,76.56,94,23.44
0836,8,36,353,262,74.22,91,25.78
0837,8,37,269,207,76.95,62,23.05
0838,8,38,272,214,78.68,58,21.32
0839,8,39,329,237,72.04,92,27.96
0840,8,40,282,213,75.53,69,24.47
0841,8,41,374,270,72.19,104,27.81
0842,8,42,462,333,72.08,129,27.92
0843,8,43,199,137,68.84,62,31.16
0844,8,44,249,194,77.91,55,22.09
0845,8,45,301,213,70.76,88,29.24
0846,8,46,288,211,73.26,77,26.74
0847,8,47,294,228,77.55,66,22.45
0848,8,48,313,230,73.48,83,26.52
0849,8,49,334,244,73.05,90,26.95
0850,8,50,333,247,74.17,86,25.83
0851,8,51,330,257,77.88,73,22.12
0852,8,52,441,342,77.55,99,22.45
0853,8,53,201,156,77.61,45,22.39
0854,8,54,300,213,71.0,87,29.0
0855,8,55,253,202,79.84,51,20.16
0856,8,56,374,281,75.13,93,24.87
0901,9,1,322,232,72.05,90,27.95
0902,9,2,273,195,71.43,78,28.57
0903,9,3,206,142,68.93,64,31.07
0904,9,4,254,183,72.05,71,27.95
0905,9,5,334,244,73.05,90,26.95
0906,9,6,316,226,71.52,90,28.48
0907,9,7,268,203,75.75,65,24.25
0908,9,8,352,254,72.16,98,27.84
0909,9,9,384,287,74.74,97,25.26
0910,9,10,250,187,74.8,63,25.2
0911,9,11,242,175,72.31,67,27.69
0912,9,12,360,275,76.39,85,23.61
0913,9,13,379,299,78.89,80,21.11
0914,9,14,390,298,76.41,92,23.59
0915,9,15,348,231,66.38,117,33.62
0916,9,16,334,238,71.26,96,28.74
0917,9,17,215,164,76.28,51,23.72
0918,9,18,240,172,71.67,68,28.33
0919,9,19,348,254,72.99,94,27.01
0920,9,20,318,241,75.79,77,24.21
0921,9,21,314,226,71.97,88,28.03
0922,9,22,375,274,73.07,101,26.93
0923,9,23,359,259,72.14,100,27.86
0924,9,24,343,255,74.34,88,25.66
0925,9,25,287,216,75.26,71,24.74
0926,9,26,304,207,68.09,97,31.91
0927,9,27,267,209,78.28,58,21.72
0928,9,28,222,152,68.47,70,31.53
0929,9,29,292,210,71.92,82,28.08
0930,9,30,289,203,70.24,86,29.76
0931,9,31,281,203,72.24,78,27.76
0932,9,32,343,263,76.68,80,23.32
0933,9,33,247,192,77.73,55,22.27
0934,9,34,284,208,73.24,76,26.76
0935,9,35,313,238,76.04,75,23.96
0936,9,36,297,212,71.38,85,28.62
0937,9,37,503,346,68.79,157,31.21
0938,9,38,319,229,71.79,90,28.21
0939,9,39,355,261,73.52,94,26.48
0940,9,40,375,291,77.6,84,22.4
0941,9,41,270,189,70.0,81,30.0
0942,9,42,350,263,75.14,87,24.86
0943,9,43,294,222,75.51,72,24.49
0944,9,44,312,239,76.6,73,23.4
0945,9,45,249,173,69.48,76,30.52
0946,9,46,330,260,78.79,70,21.21
0947,9,47,353,274,77.62,79,22.38
0948,9,48,332,246,74.1,86,25.9
0949,9,49,371,286,77.09,85,22.91
0950,9,50,450,338,75.11,112,24.89
0951,9,51,335,255,76.12,80,23.88
1001,10,1,274,206,75.18,68,24.82
1002,10,2,343,231,67.35,112,32.65
1003,10,3,366,233,63.66,133,36.34
1004,10,4,270,183,67.78,87,32.22
1005,10,5,288,202,70.14,86,29.86
1006,10,6,284,201,70.77,83,29.23
1007,10,7,265,184,69.43,81,30.57
1008,10,8,183,122,66.67,61,33.33
1009,10,9,338,235,69.53,103,30.47
1010,10,10,401,272,67.83,129,32.17
1011,10,11,462,321,69.48,141,30.52
1012,10,12,256,162,63.28,94,36.72
1013,10,13,320,222,69.38,98,30.63
1014,10,14,460,330,71.74,130,28.26
1015,10,15,617,463,75.04,154,24.96
1016,10,16,303,204,67.33,99,32.67
1017,10,17,470,307,65.32,163,34.68
1018,10,18,206,151,73.3,55,26.7
1019,10,19,373,266,71.31,107,28.69
1020,10,20,363,257,70.8,106,29.2
1021,10,21,362,277,76.52,85,23.48
1022,10,22,221,165,74.66,56,25.34
1023,10,23,307,234,76.22,73,23.78
1024,10,24,325,222,68.31,103,31.69
1025,10,25,106,82,77.36,24,22.64
1026,10,26,261,189,72.41,72,27.59
1027,10,27,303,222,73.27,81,26.73
1028,10,28,401,291,72.57,110,27.43
1029,10,29,381,282,74.02,99,25.98
1030,10,30,324,230,70.99,94,29.01
1031,10,31,316,229,72.47,87,27.53
1032,10,32,372,257,69.09,115,30.91
1033,10,33,289,198,68.51,91,31.49
1034,10,34,237,157,66.24,80,33.76
1035,10,35,378,267,70.63,111,29.37
1036,10,36,84,64,76.19,20,23.81
1101,11,1,363,259,71.35,104,28.65
1102,11,2,32,21,65.63,11,34.38
1103,11,3,420,278,66.19,142,33.81
1104,11,4,290,212,73.1,78,26.9
1105,11,5,559,366,65.47,193,34.53
1106,11,6,649,501,77.2,148,22.8
1107,11,7,396,317,80.05,79,19.95
1108,11,8,389,273,70.18,116,29.82
1109,11,9,367,260,70.84,107,29.16
1110,11,10,401,306,76.31,95,23.69
1111,11,11,460,320,69.57,140,30.43
1112,11,12,524,395,75.38,129,24.62
1113,11,13,483,347,71.84,136,28.16
1114,11,14,197,145,73.6,52,26.4
1115,11,15,150,113,75.33,37,24.67
1116,11,16,285,224,78.6,61,21.4
1117,11,17,502,360,71.71,142,28.29
1118,11,18,324,247,76.23,77,23.77
1119,11,19,558,391,70.07,167,29.93
1120,11,20,276,203,73.55,73,26.45
1121,11,21,474,343,72.36,131,27.64
1122,11,22,527,370,70.21,157,29.79
1123,11,23,206,150,72.82,56,27.18
1124,11,24,464,354,76.29,110,23.71
1125,11,25,509,348,68.37,161,31.63
1126,11,26,430,311,72.33,119,27.67
1127,11,27,166,117,70.48,49,29.52
1128,11,28,203,152,74.88,51,25.12
1129,11,29,483,345,71.43,138,28.57
1130,11,30,207,144,69.57,63,30.43
1131,11,31,364,274,75.27,90,24.73
1132,11,32,162,114,70.37,48,29.63
1133,11,33,525,418,79.62,107,20.38
1134,11,34,120,81,67.5,39,32.5
1135,11,35,64,47,73.44,17,26.56
1136,11,36,177,132,74.58,45,25.42
1137,11,37,111,81,72.97,30,27.03
1138,11,38,219,146,66.67,73,33.33
1201,12,1,363,239,65.84,124,34.16
1202,12,2,301,213,70.76,88,29.24
1203,12,3,457,315,68.93,142,31.07
1204,12,4,446,319,71.52,127,28.48
1205,12,5,311,215,69.13,96,30.87
1206,12,6,420,297,70.71,123,29.29
1207,12,7,357,242,67.79,115,32.21
1208,12,8,364,257,70.6,107,29.4
1209,12,9,310,224,72.26,86,27.74
1210,12,10,504,329,65.28,175,34.72
1211,12,11,404,261,64.6,143,35.4
1212,12,12,367,259,70.57,108,29.43
1213,12,13,406,297,73.15,109,26.85
1214,12,14,330,225,68.18,105,31.82
1215,12,15,331,217,65.56,114,34.44
1216,12,16,327,223,68.2,104,31.8
1217,12,17,449,331,73.72,118,26.28
1218,12,18,355,239,67.32,116,32.68
1219,12,19,356,245,68.82,111,31.18
1220,12,20,467,335,71.73,132,28.27
1221,12,21,403,282,69.98,121,30.02
1222,12,22,377,240,63.66,137,36.34
1223,12,23,383,271,70.76,112,29.24
1301,13,1,309,206,66.67,103,33.33
1302,13,2,254,177,69.69,77,30.31
1303,13,3,285,196,68.77,89,31.23
1304,13,4,369,241,65.31,128,34.69
1305,13,5,414,299,72.22,115,27.78
1306,13,6,284,188,66.2,96,33.8
1307,13,7,293,210,71.67,83,28.33
1308,13,8,264,182,68.94,82,31.06
1309,13,9,379,277,73.09,102,26.91
1310,13,10,277,161,58.12,116,41.88
1311,13,11,347,232,66.86,115,33.14
1312,13,12,312,218,69.87,94,30.13
1313,13,13,336,249,74.11,87,25.89
1314,13,14,333,252,75.68,81,24.32
1315,13,15,480,340,70.83,140,29.17
1316,13,16,263,195,74.14,68,25.86
1317,13,17,310,216,69.68,94,30.32
1318,13,18,282,197,69.86,85,30.14
1319,13,19,438,312,71.23,126,28.77
1320,13,20,230,155,67.39,75,32.61
1321,13,21,357,231,64.71,126,35.29
1322,13,22,349,251,71.92,98,28.08
1323,13,23,286,205,71.68,81,28.32
1324,13,24,345,236,68.41,109,31.59
1325,13,25,349,245,70.2,104,29.8
1326,13,26,350,249,71.14,101,28.86
1327,13,27,316,214,67.72,102,32.28
1328,13,28,266,188,70.68,78,29.32
1329,13,29,297,220,74.07,77,25.93
1330,13,30,271,211,77.86,60,22.14
1331,13,31,361,243,67.31,118,32.69
1332,13,32,295,187,63.39,108,36.61
1333,13,33,332,222,66.87,110,33.13
1334,13,34,344,271,78.78,73,21.22
1335,13,35,298,217,72.82,81,27.18
1336,13,36,259,184,71.04,75,28.96
1337,13,37,336,262,77.98,74,22.02
1338,13,38,282,177,62.77,105,37.23
1339,13,39,330,245,74.24,85,25.76
1340,13,40,317,231,72.87,86,27.13
1341,13,41,426,308,72.3,118,27.7
1342,13,42,326,213,65.34,113,34.66
1343,13,43,323,212,65.63,111,34.37
1344,13,44,357,276,77.31,81,22.69
1345,13,45,362,246,67.96,116,32.04
1346,13,46,406,294,72.41,112,27.59
1347,13,47,368,281,76.36,87,23.64
1348,13,48,274,186,67.88,88,32.12
1401,14,1,367,240,65.4,127,34.6
1402,14,2,523,402,76.86,121,23.14
1403,14,3,364,268,73.63,96,26.37
1404,14,4,356,219,61.52,137,38.48
1405,14,5,539,379,70.32,160,29.68
1406,14,6,210,158,75.24,52,24.76
1407,14,7,508,366,72.05,142,27.95
1408,14,8,461,337,73.1,124,26.9
1409,14,9,457,286,62.58,171,37.42
1410,14,10,284,193,67.96,91,32.04
1411,14,11,229,168,73.36,61,26.64
1412,14,12,401,269,67.08,132,32.92
1413,14,13,359,261,72.7,98,27.3
1414,14,14,367,271,73.84,96,26.16
1415,14,15,386,281,72.8,105,27.2
1416,14,16,264,188,71.21,76,28.79
1417,14,17,328,218,66.46,110,33.54
1418,14,18,184,128,69.57,56,30.43
1419,14,19,357,261,73.11,96,26.89
1420,14,20,310,226,72.9,84,27.1
1421,14,21,376,264,70.21,112,29.79
1422,14,22,492,359,72.97,133,27.03
1423,14,23,266,185,69.55,81,30.45
1424,14,24,409,292,71.39,117,28.61
1425,14,25,191,135,70.68,56,29.32
1426,14,26,283,202,71.38,81,28.62
1427,14,27,355,259,72.96,96,27.04
1428,14,28,335,254,75.82,81,24.18
1429,14,29,281,202,71.89,79,28.11
1430,14,30,264,194,73.48,70,26.52
1431,14,31,215,162,75.35,53,24.65
1501,15,1,327,213,65.14,114,34.86
1502,15,2,199,137,68.84,62,31.16
1503,15,3,213,161,75.59,52,24.41
1504,15,4,355,262,73.8,93,26.2
1505,15,5,345,231,66.96,114,33.04
1506,15,6,375,277,73.87,98,26.13
1507,15,7,182,125,68.68,57,31.32
1508,15,8,362,248,68.51,114,31.49
1509,15,9,479,353,73.7,126,26.3
1510,15,10,492,336,68.29,156,31.71
1511,15,11,440,308,70.0,132,30.0
1512,15,12,459,347,75.6,112,24.4
1513,15,13,369,256,69.38,113,30.62
1514,15,14,333,226,67.87,107,32.13
1515,15,15,320,219,68.44,101,31.56
1516,15,16,418,306,73.21,112,26.79
1517,15,17,192,141,73.44,51,26.56
1518,15,18,130,82,63.08,48,36.92
1519,15,19,292,214,73.29,78,26.71
1520,15,20,209,150,71.77,59,28.23
1521,15,21,159,114,71.7,45,28.3
1522,15,22,191,132,69.11,59,30.89
1523,15,23,213,155,72.77,58,27.23
1524,15,24,187,124,66.31,63,33.69
1601,16,1,450,335,74.44,115,25.56
1602,16,2,253,164,64.82,89,35.18
1603,16,3,231,169,73.16,62,26.84
1604,16,4,296,197,66.55,99,33.45
1605,16,5,202,148,73.27,54,26.73
1606,16,6,232,159,68.53,73,31.47
1607,16,7,271,200,73.8,71,26.2
1608,16,8,190,146,76.84,44,23.16
1609,16,9,260,190,73.08,70,26.92
1610,16,10,222,166,74.77,56,25.23
1611,16,11,295,197,66.78,98,33.22
1612,16,12,254,187,73.62,67,26.38
1613,16,13,330,229,69.39,101,30.61
1614,16,14,204,145,71.08,59,28.92
1615,16,15,260,177,68.08,83,31.92
1616,16,16,209,148,70.81,61,29.19
1617,16,17,384,282,73.44,102,26.56
1618,16,18,319,241,75.55,78,24.45
1619,16,19,262,180,68.7,82,31.3
1620,16,20,170,125,73.53,45,26.47
1621,16,21,218,168,77.06,50,22.94
1622,16,22,226,167,73.89,59,26.11
1623,16,23,376,256,68.09,120,31.91
1624,16,24,126,99,78.57,27,21.43
1625,16,25,293,210,71.67,83,28.33
1626,16,26,173,128,73.99,45,26.01
1627,16,27,182,130,71.43,52,28.57
1628,16,28,193,133,68.91,60,31.09
1629,16,29,198,138,69.7,60,30.3
1630,16,30,184,135,73.37,49,26.63
1631,16,31,234,169,72.22,65,27.78
1632,16,32,379,268,70.71,111,29.29
1633,16,33,187,135,72.19,52,27.81
1634,16,34,221,162,73.3,59,26.7
1635,16,35,407,288,70.76,119,29.24
1636,16,36,178,128,71.91,50,28.09
1701,17,1,363,261,71.9,102,28.1
1702,17,2,290,205,70.69,85,29.31
1703,17,3,304,227,74.67,77,25.33
1704,17,4,327,233,71.25,94,28.75
1705,17,5,247,174,70.45,73,29.55
1706,17,6,331,240,72.51,91,27.49
1707,17,7,349,249,71.35,100,28.65
1708,17,8,218,154,70.64,64,29.36
1709,17,9,244,175,71.72,69,28.28
1710,17,10,392,306,78.06,86,21.94
1711,17,11,235,181,77.02,54,22.98
1712,17,12,489,355,72.6,134,27.4
1713,17,13,228,170,74.56,58,25.44
1714,17,14,369,280,75.88,89,24.12
1715,17,15,327,244,74.62,83,25.38
1716,17,16,394,298,75.63,96,24.37
1717,17,17,331,232,70.09,99,29.91
1718,17,18,364,285,78.3,79,21.7
1719,17,19,194,135,69.59,59,30.41
1720,17,20,397,325,81.86,72,18.14
1721,17,21,369,279,75.61,90,24.39
1722,17,22,303,234,77.23,69,22.77
1723,17,23,212,147,69.34,65,30.66
1724,17,24,253,198,78.26,55,21.74
1725,17,25,256,184,71.88,72,28.13
1726,17,26,309,244,78.96,65,21.04
1727,17,27,190,151,79.47,39,20.53
1728,17,28,228,172,75.44,56,24.56
1729,17,29,284,213,75.0,71,25.0
1730,17,30,336,251,74.7,85,25.3
1731,17,31,203,156,76.85,47,23.15
1732,17,32,247,177,71.66,70,28.34
1733,17,33,189,131,69.31,58,30.69
1734,17,34,233,188,80.69,45,19.31
1735,17,35,212,169,79.72,43,20.28
1736,17,36,227,169,74.45,58,25.55
1737,17,37,255,191,74.9,64,25.1
1738,17,38,344,250,72.67,94,27.33
1739,17,39,292,221,75.68,71,24.32
1740,17,40,354,276,77.97,78,22.03
1741,17,41,415,308,74.22,107,25.78
1801,18,1,362,262,72.38,100,27.62
1802,18,2,436,306,70.18,130,29.82
1803,18,3,311,228,73.31,83,26.69
1804,18,4,379,293,77.31,86,22.69
1805,18,5,220,155,70.45,65,29.55
1806,18,6,336,234,69.64,102,30.36
1807,18,7,372,285,76.61,87,23.39
1808,18,8,371,277,74.66,94,25.34
1809,18,9,342,261,76.32,81,23.68
1810,18,10,458,349,76.2,109,23.8
1811,18,11,357,266,74.51,91,25.49
1812,18,12,352,280,79.55,72,20.45
1813,18,13,392,292,74.49,100,25.51
1814,18,14,375,287,76.53,88,23.47
1815,18,15,399,285,71.43,114,28.57
1816,18,16,352,264,75.0,88,25.0
1817,18,17,393,304,77.35,89,22.65
1818,18,18,274,209,76.28,65,23.72
1819,18,19,310,246,79.35,64,20.65
1820,18,20,247,183,74.09,64,25.91
1821,18,21,452,334,73.89,118,26.11
1822,18,22,386,307,79.53,79,20.47
1823,18,23,362,263,72.65,99,27.35
1824,18,24,352,251,71.31,101,28.69
1825,18,25,393,286,72.77,107,27.23
1826,18,26,455,364,80.0,91,20.0
1827,18,27,326,238,73.01,88,26.99
1828,18,28,325,242,74.46,83,25.54
1829,18,29,442,327,73.98,115,26.02
1830,18,30,455,301,66.15,154,33.85
1831,18,31,398,291,73.12,107,26.88
1832,18,32,364,270,74.18,94,25.82
1833,18,33,275,221,80.36,54,19.64
1834,18,34,406,317,78.08,89,21.92
1835,18,35,428,335,78.27,93,21.73
1836,18,36,401,290,72.32,111,27.68
1837,18,37,420,316,75.24,104,24.76
1838,18,38,320,237,74.06,83,25.94
1839,18,39,307,223,72.64,84,27.36
1840,18,40,390,297,76.15,93,23.85
1841,18,41,444,334,75.23,110,24.77
1842,18,42,325,231,71.08,94,28.92
1843,18,43,326,230,70.55,96,29.45
1844,18,44,337,241,71.51,96,28.49
1845,18,45,385,289,75.06,96,24.94
1846,18,46,441,294,66.67,147,33.33
1847,18,47,289,205,70.93,84,29.07
1848,18,48,277,205,74.01,72,25.99
1849,18,49,238,174,73.11,64,26.89
1850,18,50,257,186,72.37,71,27.63
1901,19,1,347,249,71.76,98,28.24
1902,19,2,510,393,77.06,117,22.94
1903,19,3,324,203,62.65,121,37.35
1904,19,4,456,281,61.62,175,38.38
1905,19,5,420,330,78.57,90,21.43
1906,19,6,414,270,65.22,144,34.78
1907,19,7,334,238,71.26,96,28.74
1908,19,8,413,250,60.53,163,39.47
1909,19,9,282,203,71.99,79,28.01
1910,19,10,484,368,76.03,116,23.97
1911,19,11,365,204,55.89,161,44.11
1912,19,12,331,224,67.67,107,32.33
1913,19,13,470,347,73.83,123,26.17
1914,19,14,410,319,77.8,91,22.2
1915,19,15,525,316,60.19,209,39.81
1916,19,16,383,234,61.1,149,38.9
1917,19,17,343,239,69.68,104,30.32
1918,19,18,378,320,84.66,58,15.34
1919,19,19,478,391,81.8,87,18.2
1920,19,20,331,271,81.87,60,18.13
1921,19,21,409,246,60.15,163,39.85
1922,19,22,417,326,78.18,91,21.82
1923,19,23,394,283,71.83,111,28.17
1924,19,24,301,207,68.77,94,31.23
1925,19,25,380,298,78.42,82,21.58
1926,19,26,361,297,82.27,64,17.73
1927,19,27,407,291,71.5,116,28.5
1928,19,28,464,359,77.37,105,22.63
1929,19,29,399,245,61.4,154,38.6
1930,19,30,389,259,66.58,130,33.42
1931,19,31,356,293,82.3,63,17.7
1932,19,32,358,232,64.8,126,35.2
1933,19,33,442,303,68.55,139,31.45
1934,19,34,342,273,79.82,69,20.18
1935,19,35,354,287,81.07,67,18.93
1936,19,36,548,412,75.18,136,24.82
1937,19,37,397,320,80.6,77,19.4
1938,19,38,361,267,73.96,94,26.04
1939,19,39,198,143,72.22,55,27.78
1940,19,40,430,336,78.14,94,21.86
1941,19,41,370,231,62.43,139,37.57
1942,19,42,313,237,75.72,76,24.28
1943,19,43,534,402,75.28,132,24.72
1944,19,44,437,271,62.01,166,37.99
1945,19,45,427,290,67.92,137,32.08
1946,19,46,364,272,74.73,92,25.27
1947,19,47,575,430,74.78,145,25.22
1948,19,48,470,333,70.85,137,29.15
1949,19,49,486,379,77.98,107,22.02
1950,19,50,344,244,70.93,100,29.07
1951,19,51,433,310,71.59,123,28.41
1952,19,52,484,287,59.3,197,40.7
1953,19,53,359,268,74.65,91,25.35
1954,19,54,298,170,57.05,128,42.95
1955,19,55,330,221,66.97,109,33.03
1956,19,56,424,336,79.25,88,20.75
1957,19,57,341,275,80.65,66,19.35
2001,20,1,386,283,73.32,103,26.68
2002,20,2,120,79,65.83,41,34.17
2003,20,3,341,249,73.02,92,26.98
2004,20,4,165,116,70.3,49,29.7
2005,20,5,403,269,66.75,134,33.25
2006,20,6,146,95,65.07,51,34.93
2007,20,7,427,307,71.9,120,28.1
2008,20,8,313,245,78.27,68,21.73
2009,20,9,494,363,73.48,131,26.52
2010,20,10,237,170,71.73,67,28.27
2011,20,11,462,319,69.05,143,30.95
2012,20,12,337,213,63.2,124,36.8
2013,20,13,307,223,72.64,84,27.36
2014,20,14,180,130,72.22,50,27.78
2015,20,15,358,242,67.6,116,32.4
2016,20,16,419,310,73.99,109,26.01
2017,20,17,238,153,64.29,85,35.71
2018,20,18,231,158,68.4,73,31.6
2019,20,19,380,265,69.74,115,30.26
2020,20,20,280,186,66.43,94,33.57
2021,20,21,287,195,67.94,92,32.06
2022,20,22,483,344,71.22,139,28.78
2023,20,23,207,150,72.46,57,27.54
2024,20,24,444,341,76.8,103,23.2
2025,20,25,227,152,66.96,75,33.04
2026,20,26,334,257,76.95,77,23.05
2027,20,27,174,129,74.14,45,25.86
2028,20,28,219,164,74.89,55,25.11
2029,20,29,234,174,74.36,60,25.64
2030,20,30,165,123,74.55,42,25.45
2031,20,31,396,281,70.96,115,29.04
2032,20,32,269,179,66.54,90,33.46
2033,20,33,224,162,72.32,62,27.68
2034,20,34,433,340,78.52,93,21.48
2035,20,35,256,176,68.75,80,31.25
2036,20,36,119,91,76.47,28,23.53
2037,20,37,114,85,74.56,29,25.44
2038,20,38,103,75,72.82,28,27.18
2039,20,39,28,20,71.43,8,28.57
2101,21,1,384,299,77.86,85,22.14
2102,21,2,235,158,67.23,77,32.77
2103,21,3,344,264,76.74,80,23.26
2104,21,4,300,237,79.0,63,21.0
2105,21,5,363,278,76.58,85,23.42
2106,21,6,287,218,75.96,69,24.04
2107,21,7,342,280,81.87,62,18.13
2108,21,8,362,280,77.35,82,22.65
2109,21,9,362,285,78.73,77,21.27
2110,21,10,287,224,78.05,63,21.95
2111,21,11,300,226,75.33,74,24.67
2112,21,12,303,221,72.94,82,27.06
2113,21,13,374,277,74.06,97,25.94
2114,21,14,382,297,77.75,85,22.25
2115,21,15,329,243,73.86,86,26.14
2116,21,16,303,210,69.31,93,30.69
2117,21,17,293,217,74.06,76,25.94
2118,21,18,310,241,77.74,69,22.26
2119,21,19,404,306,75.74,98,24.26
2120,21,20,302,237,78.48,65,21.52
2121,21,21,304,228,75.0,76,25.0
2122,21,22,305,218,71.48,87,28.52
2123,21,23,320,255,79.69,65,20.31
2124,21,24,371,278,74.93,93,25.07
2125,21,25,288,204,70.83,84,29.17
2126,21,26,352,242,68.75,110,31.25
2127,21,27,407,300,73.71,107,26.29
2128,21,28,424,307,72.41,117,27.59
2129,21,29,378,295,78.04,83,21.96
2130,21,30,292,215,73.63,77,26.37
2131,21,31,194,158,81.44,36,18.56
2132,21,32,255,190,74.51,65,25.49
2133,21,33,285,226,79.3,59,20.7
2134,21,34,327,243,74.31,84,25.69
2135,21,35,403,313,77.67,90,22.33
2136,21,36,339,252,74.34,87,25.66
2137,21,37,242,192,79.34,50,20.66
2138,21,38,353,251,71.1,102,28.9
2139,21,39,345,247,71.59,98,28.41
2140,21,40,320,245,76.56,75,23.44
2141,21,41,364,269,73.9,95,26.1
2142,21,42,376,268,71.28,108,28.72
2143,21,43,349,261,74.79,88,25.21
2144,21,44,366,267,72.95,99,27.05
2145,21,45,323,229,70.9,94,29.1
2146,21,46,359,274,76.32,85,23.68
2147,21,47,323,240,74.3,83,25.7
2148,21,48,348,280,80.46,68,19.54
2149,21,49,376,286,76.06,90,23.94
2150,21,50,264,194,73.48,70,26.52
2151,21,51,366,281,76.78,85,23.22
2152,21,52,343,248,72.3,95,27.7
2153,21,53,297,214,72.05,83,27.95
2154,21,54,272,195,71.69,77,28.31
2201,22,1,187,138,73.8,49,26.2
2202,22,2,440,301,68.41,139,31.59
2203,22,3,544,368,67.65,176,32.35
2204,22,4,295,207,70.17,88,29.83
2205,22,5,326,235,72.09,91,27.91
2206,22,6,324,226,69.75,98,30.25
2207,22,7,290,221,76.21,69,23.79
2208,22,8,497,382,76.86,115,23.14
2209,22,9,290,199,68.62,91,31.38
2210,22,10,455,316,69.45,139,30.55
2211,22,11,244,163,66.8,81,33.2
2212,22,12,279,184,65.95,95,34.05
2213,22,13,367,263,71.66,104,28.34
2214,22,14,296,206,69.59,90,30.41
2215,22,15,304,197,64.8,107,35.2
2216,22,16,293,213,72.7,80,27.3
2217,22,17,470,342,72.77,128,27.23
2218,22,18,329,224,68.09,105,31.91
2219,22,19,169,122,72.19,47,27.81
2220,22,20,386,263,68.13,123,31.87
2221,22,21,326,241,73.93,85,26.07
2222,22,22,345,230,66.67,115,33.33
2223,22,23,355,266,74.93,89,25.07
2224,22,24,420,311,74.05,109,25.95
2225,22,25,336,251,74.7,85,25.3
2301,23,1,322,212,65.84,110,34.16
2302,23,2,359,230,64.07,129,35.93
2303,23,3,310,200,64.52,110,35.48
2304,23,4,319,217,68.03,102,31.97
2305,23,5,362,267,73.76,95,26.24
2306,23,6,342,246,71.93,96,28.07
2307,23,7,354,254,71.75,100,28.25
2308,23,8,436,304,69.72,132,30.28
2309,23,9,352,267,75.85,85,24.15
2310,23,10,412,299,72.57,113,27.43
2311,23,11,409,311,76.04,98,23.96
2312,23,12,359,233,64.9,126,35.1
2313,23,13,345,240,69.57,105,30.43
2314,23,14,296,175,59.12,121,40.88
2315,23,15,321,235,73.21,86,26.79
2316,23,16,342,221,64.62,121,35.38
2317,23,17,284,194,68.31,90,31.69
2318,23,18,316,213,67.41,103,32.59
2319,23,19,311,204,65.59,107,34.41
2320,23,20,256,178,69.53,78,30.47
2321,23,21,298,191,64.09,107,35.91
2322,23,22,335,238,71.04,97,28.96
2323,23,23,328,215,65.55,113,34.45
2324,23,24,326,228,69.94,98,30.06
2325,23,25,322,219,68.01,103,31.99
2326,23,26,354,263,74.29,91,25.71
2327,23,27,296,196,66.22,100,33.78
2328,23,28,392,259,66.07,133,33.93
2329,23,29,301,199,66.11,102,33.89
2330,23,30,439,312,71.07,127,28.93
2331,23,31,303,210,69.31,93,30.69
2332,23,32,351,243,69.23,108,30.77
2333,23,33,402,284,70.65,118,29.35
2334,23,34,390,279,71.54,111,28.46
2335,23,35,251,158,62.95,93,37.05
2336,23,36,334,221,66.17,113,33.83
2337,23,37,373,234,62.73,139,37.27
2338,23,38,316,210,66.46,106,33.54
2339,23,39,391,301,76.98,90,23.02
2401,24,1,239,171,71.55,68,28.45
2402,24,2,284,209,73.59,75,26.41
2403,24,3,344,233,67.73,111,32.27
2404,24,4,234,179,76.5,55,23.5
2405,24,5,162,129,79.63,33,20.37
2406,24,6,320,237,74.06,83,25.94
2407,24,7,226,165,73.01,61,26.99
2408,24,8,132,86,65.15,46,34.85
2409,24,9,268,183,68.28,85,31.72
2410,24,10,145,103,71.03,42,28.97
2411,24,11,288,208,72.22,80,27.78
2412,24,12,182,120,65.93,62,34.07
2413,24,13,179,118,65.92,61,34.08
2414,24,14,229,163,71.18,66,28.82
2415,24,15,151,109,72.19,42,27.81
2416,24,16,861,519,60.28,342,39.72
2417,24,17,204,147,72.06,57,27.94
2418,24,18,241,180,74.69,61,25.31
2419,24,19,314,226,71.97,88,28.03
2420,24,20,257,186,72.37,71,27.63
2421,24,21,153,96,62.75,57,37.25
2422,24,22,341,231,67.74,110,32.26
2423,24,23,253,174,68.77,79,31.23
2424,24,24,332,215,64.76,117,35.24
2425,24,25,208,154,74.04,54,25.96
2426,24,26,407,312,76.66,95,23.34
2427,24,27,303,230,75.91,73,24.09
2428,24,28,181,131,72.38,50,27.62
2429,24,29,202,152,75.25,50,24.75
2430,24,30,178,131,73.6,47,26.4
2431,24,31,293,191,65.19,102,34.81
2432,24,32,147,106,72.11,41,27.89
2433,24,33,176,137,77.84,39,22.16
2434,24,34,273,197,72.16,76,27.84
2435,24,35,261,179,68.58,82,31.42
2436,24,36,328,240,73.17,88,26.83
2437,24,37,136,99,72.79,37,27.21
2438,24,38,244,179,73.36,65,26.64
2439,24,39,271,184,67.9,87,32.1
2440,24,40,330,228,69.09,102,30.91
2441,24,41,128,89,69.53,39,30.47
2501,25,1,358,261,72.91,97,27.09
2502,25,2,531,345,64.97,186,35.03
2503,25,3,702,555,79.06,147,20.94
2504,25,4,343,249,72.59,94,27.41
2505,25,5,433,279,64.43,154,35.57
2506,25,6,135,103,76.3,32,23.7
2507,25,7,438,296,67.58,142,32.42
2508,25,8,519,348,67.05,171,32.95
2509,25,9,435,307,70.57,128,29.43
2510,25,10,567,485,85.54,82,14.46
2511,25,11,494,358,72.47,136,27.53
2512,25,12,437,320,73.23,117,26.77
2513,25,13,512,363,70.9,149,29.1
2514,25,14,284,230,80.99,54,19.01
2515,25,15,380,244,64.21,136,35.79
2516,25,16,691,575,83.21,116,16.79
2517,25,17,448,321,71.65,127,28.35
2518,25,18,222,178,80.18,44,19.82
2519,25,19,450,297,66.0,153,34.0
2520,25,20,243,144,59.26,99,40.74
2521,25,21,839,687,81.88,152,18.12
2522,25,22,464,324,69.83,140,30.17
2523,25,23,504,360,71.43,144,28.57
2524,25,24,457,318,69.58,139,30.42
2525,25,25,382,296,77.49,86,22.51
2526,25,26,462,320,69.26,142,30.74
2527,25,27,554,438,79.06,116,20.94
2528,25,28,479,347,72.44,132,27.56
2529,25,29,328,235,71.65,93,28.35
2530,25,30,437,271,62.01,166,37.99
2531,25,31,808,670,82.92,138,17.08
2532,25,32,352,225,63.92,127,36.08
2601,26,1,364,271,74.45,93,25.55
2602,26,2,272,183,67.28,89,32.72
2603,26,3,418,314,75.12,104,24.88
2604,26,4,246,154,62.6,92,37.4
2605,26,5,319,224,70.22,95,29.78
2606,26,6,295,215,72.88,80,27.12
2607,26,7,325,238,73.23,87,26.77
2608,26,8,213,136,63.85,77,36.15
2609,26,9,286,210,73.43,76,26.57
2610,26,10,339,226,66.67,113,33.33
2611,26,11,319,218,68.34,101,31.66
2612,26,12,348,245,70.4,103,29.6
2613,26,13,187,129,68.98,58,31.02
2614,26,14,273,182,66.67,91,33.33
2615,26,15,212,155,73.11,57,26.89
2616,26,16,184,128,69.57,56,30.43
2617,26,17,307,232,75.57,75,24.43
2618,26,18,255,178,69.8,77,30.2
2619,26,19,208,135,64.9,73,35.1
2620,26,20,286,210,73.43,76,26.57
2621,26,21,415,294,70.84,121,29.16
2622,26,22,181,132,72.93,49,27.07
2623,26,23,248,166,66.94,82,33.06
2624,26,24,270,183,67.78,87,32.22
2625,26,25,246,178,72.36,68,27.64
2626,26,26,247,165,66.8,82,33.2
2627,26,27,369,253,68.56,116,31.44
2628,26,28,443,342,77.2,101,22.8
2629,26,29,175,121,69.14,54,30.86
2630,26,30,272,184,67.65,88,32.35
2631,26,31,151,101,66.89,50,33.11
2632,26,32,399,296,74.19,103,25.81
2633,26,33,366,273,74.59,93,25.41
2634,26,34,347,239,68.88,108,31.12
2635,26,35,267,181,67.79,86,32.21
2636,26,36,329,232,70.52,97,29.48
2637,26,37,347,264,76.08,83,23.92
2638,26,38,163,118,72.39,45,27.61
2639,26,39,387,264,68.22,123,31.78
2640,26,40,198,124,62.63,74,37.37
2641,26,41,390,275,70.51,115,29.49
2642,26,42,274,195,71.17,79,28.83
2643,26,43,216,155,71.76,61,28.24
2644,26,44,181,137,75.69,44,24.31
2645,26,45,177,116,65.54,61,34.46
2646,26,46,246,167,67.89,79,32.11
2647,26,47,240,174,72.5,66,27.5
2648,26,48,349,247,70.77,102,29.23
2649,26,49,209,154,73.68,55,26.32
2701,27,1,876,718,81.96,158,18.04
2702,27,2,400,318,79.5,82,20.5
2703,27,3,171,138,80.7,33,19.3
2704,27,4,205,145,70.73,60,29.27
2705,27,5,301,203,67.44,98,32.56
2706,27,6,450,361,80.22,89,19.78
2707,27,7,563,440,78.15,123,21.85
2708,27,8,321,236,73.52,85,26.48
2709,27,9,181,149,82.32,32,17.68
2710,27,10,262,201,76.72,61,23.28
2711,27,11,449,369,82.18,80,17.82
2712,27,12,300,258,86.0,42,14.0
2713,27,13,531,419,78.91,112,21.09
2714,27,14,187,123,65.78,64,34.22
2715,27,15,179,120,67.04,59,32.96
2716,27,16,449,355,79.06,94,20.94
2717,27,17,392,299,76.28,93,23.72
2718,27,18,242,168,69.42,74,30.58
2719,27,19,179,131,73.18,48,26.82
2720,27,20,267,178,66.67,89,33.33
2721,27,21,354,290,81.92,64,18.08
2722,27,22,152,98,64.47,54,35.53
2723,27,23,219,162,73.97,57,26.03
2724,27,24,250,177,70.8,73,29.2
2725,27,25,338,243,71.89,95,28.11
2726,27,26,241,179,74.27,62,25.73
2727,27,27,488,371,76.02,117,23.98
2728,27,28,493,399,80.93,94,19.07
2729,27,29,253,179,70.75,74,29.25
2730,27,30,167,118,70.66,49,29.34
2731,27,31,273,194,71.06,79,28.94
2732,27,32,351,260,74.07,91,25.93
2733,27,33,542,436,80.44,106,19.56
2734,27,34,190,133,70.0,57,30.0
2735,27,35,508,401,78.94,107,21.06
2736,27,36,264,192,72.73,72,27.27
2737,27,37,339,278,82.01,61,17.99
2738,27,38,506,405,80.04,101,19.96
2739,27,39,259,185,71.43,74,28.57
2740,27,40,527,391,74.19,136,25.81
2741,27,41,254,196,77.17,58,22.83
2742,27,42,256,206,80.47,50,19.53
2743,27,43,308,234,75.97,74,24.03
2744,27,44,265,186,70.19,79,29.81
2745,27,45,1090,889,81.56,201,18.44
2746,27,46,337,300,89.02,37,10.98
2747,27,47,229,187,81.66,42,18.34
2748,27,48,672,516,76.79,156,23.21
2749,27,49,265,200,75.47,65,24.53
2750,27,50,310,222,71.61,88,28.39
2801,28,1,210,155,73.81,55,26.19
2802,28,2,247,184,74.49,63,25.51
2803,28,3,212,156,73.58,56,26.42
2804,28,4,276,219,79.35,57,20.65
2805,28,5,179,132,73.74,47,26.26
2806,28,6,168,136,80.95,32,19.05
2807,28,7,272,205,75.37,67,24.63
2808,28,8,477,382,80.08,95,19.92
2809,28,9,278,204,73.38,74,26.62
2810,28,10,381,280,73.49,101,26.51
2811,28,11,685,485,70.8,200,29.2
2812,28,12,257,207,80.54,50,19.46
2813,28,13,270,199,73.7,71,26.3
2814,28,14,275,205,74.55,70,25.45
2815,28,15,53,45,84.91,8,15.09
2816,28,16,185,141,76.22,44,23.78
2817,28,17,239,182,76.15,57,23.85
2818,28,18,240,171,71.25,69,28.75
2819,28,19,279,199,71.33,80,28.67
2820,28,20,234,173,73.93,61,26.07
2821,28,21,253,187,73.91,66,26.09
2822,28,22,255,194,76.08,61,23.92
2823,28,23,328,242,73.78,86,26.22
2824,28,24,240,160,66.67,80,33.33
2825,28,25,431,324,75.17,107,24.83
2826,28,26,245,181,73.88,64,26.12
2827,28,27,308,249,80.84,59,19.16
2828,28,28,395,318,80.51,77,19.49
2829,28,29,154,113,73.38,41,26.62
2830,28,30,47,38,80.85,9,19.15
2831,28,31,308,239,77.6,69,22.4
2832,28,32,272,193,70.96,79,29.04
2833,28,33,303,225,74.26,78,25.74
2834,28,34,496,349,70.36,147,29.64
2835,28,35,300,223,74.33,77,25.67
2836,28,36,133,105,78.95,28,21.05
2837,28,37,303,235,77.56,68,22.44
2838,28,38,120,91,75.83,29,24.17
2839,28,39,208,139,66.83,69,33.17
2840,28,40,357,276,77.31,81,22.69
2841,28,41,179,123,68.72,56,31.28
2842,28,42,283,206,72.79,77,27.21
2843,28,43,330,251,76.06,79,23.94
2844,28,44,215,155,72.09,60,27.91
2845,28,45,453,365,80.57,88,19.43
2846,28,46,573,407,71.03,166,28.97
2901,29,1,520,399,76.73,121,23.27
2902,29,2,439,335,76.31,104,23.69
2903,29,3,303,225,74.26,78,25.74
2904,29,4,427,320,74.94,107,25.06
2905,29,5,273,200,73.26,73,26.74
2906,29,6,260,195,75.0,65,25.0
2907,29,7,385,292,75.84,93,24.16
2908,29,8,342,257,75.15,85,24.85
2909,29,9,417,321,76.98,96,23.02
2910,29,10,481,358,74.43,123,25.57
2911,29,11,193,145,75.13,48,24.87
2912,29,12,448,350,78.13,98,21.88
2913,29,13,333,232,69.67,101,30.33
2914,29,14,317,243,76.66,74,23.34
2915,29,15,409,315,77.02,94,22.98
2916,29,16,341,270,79.18,71,20.82
2917,29,17,352,294,83.52,58,16.48
2918,29,18,328,245,74.7,83,25.3
2919,29,19,353,265,75.07,88,24.93
2920,29,20,388,298,76.8,90,23.2
2921,29,21,439,291,66.29,148,33.71
2922,29,22,265,190,71.7,75,28.3
2923,29,23,442,319,72.17,123,27.83
2924,29,24,357,268,75.07,89,24.93
2925,29,25,412,320,77.67,92,22.33
2926,29,26,337,269,79.82,68,20.18
2927,29,27,340,252,74.12,88,25.88
2928,29,28,422,330,78.2,92,21.8
2929,29,29,436,307,70.41,129,29.59
2930,29,30,509,376,73.87,133,26.13
2931,29,31,397,264,66.5,133,33.5
2932,29,32,401,276,68.83,125,31.17
2933,29,33,247,189,76.52,58,23.48
2934,29,34,263,183,69.58,80,30.42
2935,29,35,282,192,68.09,90,31.91
2936,29,36,330,253,76.67,77,23.33
2937,29,37,346,236,68.21,110,31.79
2938,29,38,477,338,70.86,139,29.14
2939,29,39,402,298,74.13,104,25.87
2940,29,40,404,308,76.24,96,23.76
2941,29,41,311,224,72.03,87,27.97
2942,29,42,396,306,77.27,90,22.73
2943,29,43,460,346,75.22,114,24.78
2944,29,44,388,273,70.36,115,29.64
3001,30,1,459,338,73.64,121,26.36
3002,30,2,403,296,73.45,107,26.55
3003,30,3,353,261,73.94,92,26.06
3004,30,4,398,276,69.35,122,30.65
3005,30,5,330,238,72.12,92,27.88
3006,30,6,284,201,70.77,83,29.23
3007,30,7,459,332,72.33,127,27.67
3008,30,8,508,355,69.88,153,30.12
3009,30,9,349,249,71.35,100,28.65
3010,30,10,391,278,71.1,113,28.9
3011,30,11,412,291,70.63,121,29.37
3012,30,12,378,267,70.63,111,29.37
3013,30,13,418,304,72.73,114,27.27
3014,30,14,297,206,69.36,91,30.64
3015,30,15,369,288,78.05,81,21.95
3016,30,16,225,155,68.89,70,31.11
3017,30,17,427,313,73.3,114,26.7
3018,30,18,518,373,72.01,145,27.99
3019,30,19,441,314,71.2,127,28.8
3020,30,20,437,314,71.85,123,28.15
3021,30,21,288,210,72.92,78,27.08
3022,30,22,619,426,68.82,193,31.18
3023,30,23,534,390,73.03,144,26.97
3024,30,24,593,405,68.3,188,31.7
3025,30,25,616,422,68.51,194,31.49
3026,30,26,268,191,71.27,77,28.73
3027,30,27,299,218,72.91,81,27.09
3028,30,28,435,327,75.17,108,24.83
3029,30,29,292,211,72.26,81,27.74
3030,30,30,179,119,66.48,60,33.52
3031,30,31,266,185,69.55,81,30.45
3032,30,32,342,249,72.81,93,27.19
3101,31,1,268,172,64.18,96,35.82
3102,31,2,252,184,73.02,68,26.98
3103,31,3,267,194,72.66,73,27.34
3104,31,4,354,261,73.73,93,26.27
3105,31,5,308,234,75.97,74,24.03
3106,31,6,192,139,72.4,53,27.6
3107,31,7,401,304,75.81,97,24.19
3108,31,8,266,178,66.92,88,33.08
3109,31,9,312,225,72.12,87,27.88
3110,31,10,339,267,78.76,72,21.24
3111,31,11,211,155,73.46,56,26.54
3112,31,12,237,165,69.62,72,30.38
3113,31,13,305,221,72.46,84,27.54
3114,31,14,269,202,75.09,67,24.91
3115,31,15,283,203,71.73,80,28.27
3116,31,16,343,240,69.97,103,30.03
3117,31,17,260,199,76.54,61,23.46
3118,31,18,268,199,74.25,69,25.75
3119,31,19,257,167,64.98,90,35.02
3120,31,20,243,156,64.2,87,35.8
3121,31,21,250,180,72.0,70,28.0
3122,31,22,243,170,69.96,73,30.04
3123,31,23,306,218,71.24,88,28.76
3124,31,24,289,213,73.7,76,26.3
3125,31,25,290,204,70.34,86,29.66
3126,31,26,284,206,72.54,78,27.46
3127,31,27,304,209,68.75,95,31.25
3128,31,28,271,197,72.69,74,27.31
3129,31,29,271,194,71.59,77,28.41
3130,31,30,237,179,75.53,58,24.47
3131,31,31,234,165,70.51,69,29.49
3132,31,32,230,161,70.0,69,30.0
3133,31,33,263,194,73.76,69,26.24
3134,31,34,287,200,69.69,87,30.31
3135,31,35,337,222,65.88,115,34.12
3136,31,36,279,205,73.48,74,26.52
3137,31,37,269,189,70.26,80,29.74
3138,31,38,256,189,73.83,67,26.17
3139,31,39,312,233,74.68,79,25.32
3140,31,40,321,219,68.22,102,31.78
3141,31,41,263,185,70.34,78,29.66
3201,32,1,644,507,78.73,137,21.27
3202,32,2,565,458,81.06,107,18.94
3203,32,3,536,405,75.56,131,24.44
3204,32,4,448,383,85.49,65,14.51
3205,32,5,538,438,81.41,100,18.59
3206,32,6,602,519,86.21,83,13.79
3207,32,7,581,459,79.0,122,21.0
3208,32,8,621,520,83.74,101,16.26
3209,32,9,514,405,78.79,109,21.21
3210,32,10,560,433,77.32,127,22.68
3211,32,11,454,342,75.33,112,24.67
3212,32,12,346,261,75.43,85,24.57
3213,32,13,546,449,82.23,97,17.77
3214,32,14,538,427,79.37,111,20.63
3215,32,15,482,372,77.18,110,22.82
3216,32,16,475,367,77.26,108,22.74
3217,32,17,486,341,70.16,145,29.84
3218,32,18,488,405,82.99,83,17.01
3219,32,19,475,389,81.89,86,18.11
3220,32,20,483,383,79.3,100,20.7
3221,32,21,512,421,82.23,91,17.77
3222,32,22,633,499,78.83,134,21.17
3223,32,23,535,453,84.67,82,15.33
3224,32,24,434,365,84.1,69,15.9
3225,32,25,504,419,83.13,85,16.87
3226,32,26,508,400,78.74,108,21.26
3227,32,27,514,416,80.93,98,19.07
3228,32,28,530,404,76.23,126,23.77
3229,32,29,532,425,79.89,107,20.11
3230,32,30,494,423,85.63,71,14.37
3231,32,31,543,436,80.29,107,19.71
3232,32,32,594,508,85.52,86,14.48
3233,32,33,454,389,85.68,65,14.32
3234,32,34,556,451,81.12,105,18.88
3235,32,35,477,375,78.62,102,21.38
3236,32,36,513,441,85.96,72,14.04
3237,32,37,592,462,78.04,130,21.96
3238,32,38,485,387,79.79,98,20.21
3239,32,39,562,477,84.88,85,15.12
3240,32,40,512,426,83.2,86,16.8
3241,32,41,535,419,78.32,116,21.68
3242,32,42,476,382,80.25,94,19.75
3243,32,43,463,334,72.14,129,27.86
3301,33,1,565,408,72.21,157,27.79
3302,33,2,695,517,74.39,178,25.61
3303,33,3,745,573,76.91,172,23.09
3304,33,4,714,521,72.97,193,27.03
3305,33,5,509,384,75.44,125,24.56
3306,33,6,480,350,72.92,130,27.08
3307,33,7,566,424,74.91,142,25.09
3308,33,8,661,541,81.85,120,18.15
3309,33,9,596,455,76.34,141,23.66
3310,33,10,447,346,77.4,101,22.6
3311,33,11,537,410,76.35,127,23.65
3312,33,12,540,397,73.52,143,26.48
3313,33,13,523,385,73.61,138,26.39
3314,33,14,254,187,73.62,67,26.38
3315,33,15,553,430,77.76,123,22.24
3316,33,16,722,530,73.41,192,26.59
3317,33,17,554,406,73.29,148,26.71
3318,33,18,750,553,73.73,197,26.27
3319,33,19,638,474,74.29,164,25.71
3320,33,20,684,538,78.65,146,21.35
3321,33,21,590,415,70.34,175,29.66
3322,33,22,498,372,74.7,126,25.3
3323,33,23,605,453,74.88,152,25.12
3324,33,24,675,550,81.48,125,18.52
3325,33,25,647,500,77.28,147,22.72
3326,33,26,396,281,70.96,115,29.04
3327,33,27,630,461,73.17,169,26.83
3328,33,28,503,367,72.96,136,27.04
3401,34,1,397,292,73.55,105,26.45
3402,34,2,310,259,83.55,51,16.45
3403,34,3,357,269,75.35,88,24.65
3404,34,4,278,222,79.86,56,20.14
3405,34,5,306,232,75.82,74,24.18
3406,34,6,399,314,78.7,85,21.3
3407,34,7,372,288,77.42,84,22.58
3408,34,8,302,227,75.17,75,24.83
3409,34,9,239,170,71.13,69,28.87
3410,34,10,299,229,76.59,70,23.41
3411,34,11,310,221,71.29,89,28.71
3412,34,12,375,295,78.67,80,21.33
3413,34,13,368,278,75.54,90,24.46
3414,34,14,271,201,74.17,70,25.83
3415,34,15,334,257,76.95,77,23.05
3416,34,16,323,242,74.92,81,25.08
3417,34,17,441,353,80.05,88,19.95
3418,34,18,214,150,70.09,64,29.91
3419,34,19,384,293,76.3,91,23.7
3420,34,20,408,323,79.17,85,20.83
3421,34,21,427,327,76.58,100,23.42
3422,34,22,358,286,79.89,72,20.11
3423,34,23,309,236,76.38,73,23.62
3424,34,24,305,238,78.03,67,21.97
3425,34,25,530,398,75.09,132,24.91
3426,34,26,418,325,77.75,93,22.25
3427,34,27,287,199,69.34,88,30.66
3428,34,28,221,165,74.66,56,25.34
3429,34,29,285,198,69.47,87,30.53
3430,34,30,329,269,81.76,60,18.24
3431,34,31,283,217,76.68,66,23.32
3432,34,32,350,268,76.57,82,23.43
3433,34,33,298,221,74.16,77,25.84
3434,34,34,419,334,79.71,85,20.29
3435,34,35,441,332,75.28,109,24.72
3436,34,36,310,238,76.77,72,23.23
3437,34,37,204,149,73.04,55,26.96
3438,34,38,182,132,72.53,50,27.47
3439,34,39,270,187,69.26,83,30.74
3440,34,40,380,289,76.05,91,23.95
3441,34,41,216,144,66.67,72,33.33
3442,34,42,356,283,79.49,73,20.51
3443,34,43,329,266,80.85,63,19.15
3444,34,44,307,240,78.18,67,21.82
3445,34,45,352,266,75.57,86,24.43
3446,34,46,245,196,80.0,49,20.0
3447,34,47,316,256,81.01,60,18.99
3448,34,48,359,283,78.83,76,21.17
3449,34,49,324,267,82.41,57,17.59
3450,34,50,287,226,78.75,61,21.25
3451,34,51,408,310,75.98,98,24.02
3452,34,52,275,218,79.27,57,20.73
3453,34,53,248,182,73.39,66,26.61
3501,35,1,453,322,71.08,131,28.92
3502,35,2,464,346,74.57,118,25.43
3503,35,3,421,290,68.88,131,31.12
3504,35,4,470,341,72.55,129,27.45
3505,35,5,392,285,72.7,107,27.3
3506,35,6,486,358,73.66,128,26.34
3507,35,7,464,338,72.84,126,27.16
3508,35,8,473,334,70.61,139,29.39
3509,35,9,400,287,71.75,113,28.25
3510,35,10,523,382,73.04,141,26.96
3511,35,11,510,376,73.73,134,26.27
3512,35,12,314,214,68.15,100,31.85
3513,35,13,322,213,66.15,109,33.85
3514,35,14,366,257,70.22,109,29.78
3515,35,15,557,409,73.43,148,26.57
3516,35,16,246,170,69.11,76,30.89
3517,35,17,457,318,69.58,139,30.42
3518,35,18,318,220,69.18,98,30.82
3519,35,19,287,213,74.22,74,25.78
3520,35,20,475,349,73.47,126,26.53
3521,35,21,462,328,71.0,134,29.0
3522,35,22,580,427,73.62,153,26.38
3523,35,23,466,336,72.1,130,27.9
3524,35,24,408,300,73.53,108,26.47
3525,35,25,464,338,72.84,126,27.16
3526,35,26,402,291,72.39,111,27.61
3527,35,27,416,319,76.68,97,23.32
3528,35,28,457,325,71.12,132,28.88
3529,35,29,434,320,73.73,114,26.27
3530,35,30,417,292,70.02,125,29.98
3531,35,31,495,378,76.36,117,23.64
3601,36,1,380,273,71.84,107,28.16
3602,36,2,371,254,68.46,117,31.54
3603,36,3,345,253,73.33,92,26.67
3604,36,4,433,327,75.52,106,24.48
3605,36,5,342,251,73.39,91,26.61
3606,36,6,345,241,69.86,104,30.14
3607,36,7,384,267,69.53,117,30.47
3608,36,8,318,226,71.07,92,28.93
3609,36,9,380,266,70.0,114,30.0
3610,36,10,497,370,74.45,127,25.55
3611,36,11,271,176,64.94,95,35.06
3612,36,12,241,167,69.29,74,30.71
3613,36,13,274,203,74.09,71,25.91
3614,36,14,424,302,71.23,122,28.77
3615,36,15,376,289,76.86,87,23.14
3616,36,16,375,271,72.27,104,27.73
3617,36,17,466,342,73.39,124,26.61
3618,36,18,396,267,67.42,129,32.58
3619,36,19,492,329,66.87,163,33.13
3620,36,20,439,309,70.39,130,29.61
3621,36,21,342,221,64.62,121,35.38
3622,36,22,355,232,65.35,123,34.65
3623,36,23,351,241,68.66,110,31.34
3624,36,24,451,329,72.95,122,27.05
3625,36,25,402,285,70.9,117,29.1
3626,36,26,354,246,69.49,108,30.51
3627,36,27,327,232,70.95,95,29.05
3628,36,28,346,252,72.83,94,27.17
3629,36,29,417,294,70.5,123,29.5
3630,36,30,366,248,67.76,118,32.24
3701,37,1,203,154,75.86,49,24.14
3702,37,2,300,205,68.33,95,31.67
3703,37,3,222,149,67.12,73,32.88
3704,37,4,262,162,61.83,100,38.17
3705,37,5,315,235,74.6,80,25.4
3706,37,6,214,164,76.64,50,23.36
3707,37,7,248,185,74.6,63,25.4
3708,37,8,221,162,73.3,59,26.7
3709,37,9,301,212,70.43,89,29.57
3710,37,10,396,296,74.75,100,25.25
3711,37,11,202,143,70.79,59,29.21
3712,37,12,295,212,71.86,83,28.14
3713,37,13,229,172,75.11,57,24.89
3714,37,14,364,264,72.53,100,27.47
3715,37,15,333,254,76.28,79,23.72
3716,37,16,347,247,71.18,100,28.82
3717,37,17,229,171,74.67,58,25.33
3718,37,18,268,195,72.76,73,27.24
3719,37,19,232,175,75.43,57,24.57
3720,37,20,280,210,75.0,70,25.0
3721,37,21,244,178,72.95,66,27.05
3722,37,22,293,213,72.7,80,27.3
3723,37,23,309,241,77.99,68,22.01
3724,37,24,300,217,72.33,83,27.67
3725,37,25,267,175,65.54,92,34.46
3726,37,26,425,302,71.06,123,28.94
3727,37,27,313,233,74.44,80,25.56
3728,37,28,268,194,72.39,74,27.61
3729,37,29,275,206,74.91,69,25.09
3730,37,30,276,208,75.36,68,24.64
3731,37,31,365,284,77.81,81,22.19
3732,37,32,279,220,78.85,59,21.15
3733,37,33,234,182,77.78,52,22.22
3734,37,34,272,195,71.69,77,28.31
3735,37,35,323,237,73.37,86,26.63
3736,37,36,217,147,67.74,70,32.26
3737,37,37,323,236,73.07,87,26.93
3738,37,38,335,251,74.93,84,25.07
3739,37,39,262,193,73.66,69,26.34
3740,37,40,326,248,76.07,78,23.93
3741,37,41,306,229,74.84,77,25.16
3801,38,1,378,276,73.02,102,26.98
3802,38,2,371,246,66.31,125,33.69
3803,38,3,389,271,69.67,118,30.33
3804,38,4,367,247,67.3,120,32.7
3805,38,5,362,247,68.23,115,31.77
3806,38,6,388,260,67.01,128,32.99
3807,38,7,366,251,68.58,115,31.42
3808,38,8,381,263,69.03,118,30.97
3809,38,9,463,319,68.9,144,31.1
3810,38,10,352,225,63.92,127,36.08
3811,38,11,352,275,78.13,77,21.88
3812,38,12,343,223,65.01,120,34.99
3813,38,13,436,302,69.27,134,30.73
3814,38,14,424,293,69.1,131,30.9
3815,38,15,359,261,72.7,98,27.3
3816,38,16,384,247,64.32,137,35.68
3817,38,17,459,309,67.32,150,32.68
3818,38,18,403,289,71.71,114,28.29
3819,38,19,419,317,75.66,102,24.34
3820,38,20,395,262,66.33,133,33.67
3821,38,21,391,290,74.17,101,25.83
3822,38,22,358,260,72.63,98,27.37
3823,38,23,409,294,71.88,115,28.12
3824,38,24,377,266,70.56,111,29.44
3825,38,25,366,267,72.95,99,27.05
3826,38,26,394,295,74.87,99,25.13
3827,38,27,377,257,68.17,120,31.83
3828,38,28,485,319,65.77,166,34.23
3829,38,29,402,272,67.66,130,32.34
3830,38,30,392,254,64.8,138,35.2
3831,38,31,409,311,76.04,98,23.96
3832,38,32,380,278,73.16,102,26.84
3833,38,33,327,246,75.23,81,24.77
3834,38,34,358,265,74.02,93,25.98
3835,38,35,370,270,72.97,100,27.03
3836,38,36,366,268,73.22,98,26.78
3837,38,37,384,253,65.89,131,34.11
3838,38,38,380,261,68.68,119,31.32
3839,38,39,424,300,70.75,124,29.25
3840,38,40,399,278,69.67,121,30.33
3841,38,41,350,263,75.14,87,24.86
3901,39,1,382,277,72.51,105,27.49
3902,39,2,247,209,84.62,38,15.38
3903,39,3,460,353,76.74,107,23.26
3904,39,4,390,279,71.54,111,28.46
3905,39,5,419,314,74.94,105,25.06
3906,39,6,440,310,70.45,130,29.55
3907,39,7,365,282,77.26,83,22.74
3908,39,8,419,329,78.52,90,21.48
3909,39,9,370,286,77.3,84,22.7
3910,39,10,196,156,79.59,40,20.41
3911,39,11,387,284,73.39,103,26.61
3912,39,12,556,399,71.76,157,28.24
3913,39,13,336,247,73.51,89,26.49
3914,39,14,418,289,69.14,129,30.86
3915,39,15,457,345,75.49,112,24.51
3916,39,16,375,273,72.8,102,27.2
3917,39,17,411,311,75.67,100,24.33
3918,39,18,408,312,76.47,96,23.53
3919,39,19,392,300,76.53,92,23.47
3920,39,20,509,360,70.73,149,29.27
3921,39,21,402,264,65.67,138,34.33
3922,39,22,405,296,73.09,109,26.91
3923,39,23,416,302,72.6,114,27.4
3924,39,24,497,342,68.81,155,31.19
3925,39,25,347,269,77.52,78,22.48
3926,39,26,366,259,70.77,107,29.23
3927,39,27,57,43,75.44,14,24.56
3928,39,28,516,391,75.78,125,24.22
3929,39,29,214,156,72.9,58,27.1
3930,39,30,509,403,79.17,106,20.83
3931,39,31,365,274,75.07,91,24.93
3932,39,32,298,215,72.15,83,27.85
3933,39,33,409,317,77.51,92,22.49
3934,39,34,486,348,71.6,138,28.4
3935,39,35,405,318,78.52,87,21.48
3936,39,36,98,86,87.76,12,12.24
3937,39,37,372,300,80.65,72,19.35
3938,39,38,208,166,79.81,42,20.19
3939,39,39,251,198,78.88,53,21.12
3940,39,40,404,293,72.52,111,27.48
3941,39,41,408,316,77.45,92,22.55
3942,39,42,423,333,78.72,90,21.28
3943,39,43,414,295,71.26,119,28.74
3944,39,44,322,233,72.36,89,27.64
3945,39,45,355,267,75.21,88,24.79
4001,40,1,404,310,76.73,94,23.27
4002,40,2,478,377,78.87,101,21.13
4003,40,3,595,465,78.15,130,21.85
4004,40,4,289,226,78.2,63,21.8
4005,40,5,534,428,80.15,106,19.85
4006,40,6,548,420,76.64,128,23.36
4007,40,7,453,370,81.68,83,18.32
4008,40,8,622,496,79.74,126,20.26
4009,40,9,367,293,79.84,74,20.16
4010,40,10,525,394,75.05,131,24.95
4011,40,11,487,391,80.29,96,19.71
4012,40,12,397,321,80.86,76,19.14
4013,40,13,700,552,78.86,148,21.14
4014,40,14,422,311,73.7,111,26.3
4015,40,15,446,341,76.46,105,23.54
4016,40,16,630,480,76.19,150,23.81
4017,40,17,392,299,76.28,93,23.72
4018,40,18,376,299,79.52,77,20.48
4019,40,19,578,434,75.09,144,24.91
4020,40,20,489,374,76.48,115,23.52
4021,40,21,546,456,83.52,90,16.48
4022,40,22,587,488,83.13,99,16.87
4023,40,23,576,467,81.08,109,18.92
4024,40,24,437,339,77.57,98,22.43
4025,40,25,561,423,75.4,138,24.6
4026,40,26,493,402,81.54,91,18.46
4027,40,27,581,446,76.76,135,23.24
4028,40,28,514,384,74.71,130,25.29
4029,40,29,488,382,78.28,106,21.72
4030,40,30,382,295,77.23,87,22.77
4031,40,31,532,436,81.95,96,18.05
4032,40,32,524,433,82.63,91,17.37
4033,40,33,463,364,78.62,99,21.38
4034,40,34,401,321,80.05,80,19.95
4035,40,35,326,258,79.14,68,20.86
4036,40,36,406,328,80.79,78,19.21
4037,40,37,501,390,77.84,111,22.16
4038,40,38,596,488,81.88,108,18.12
4039,40,39,188,142,75.53,46,24.47
4101,41,1,414,245,59.18,169,40.82
4102,41,2,455,285,62.64,170,37.36
4103,41,3,419,296,70.64,123,29.36
4104,41,4,410,291,70.98,119,29.02
4105,41,5,493,347,70.39,146,29.61
4106,41,6,482,367,76.14,115,23.86
4107,41,7,430,292,67.91,138,32.09
4108,41,8,429,280,65.27,149,34.73
4109,41,9,370,252,68.11,118,31.89
4110,41,10,429,306,71.33,123,28.67
4111,41,11,457,275,60.18,182,39.82
4112,41,12,453,320,70.64,133,29.36
4113,41,13,468,312,66.67,156,33.33
4114,41,14,443,323,72.91,120,27.09
4115,41,15,513,377,73.49,136,26.51
4116,41,16,411,283,68.86,128,31.14
4117,41,17,374,254,67.91,120,32.09
4118,41,18,378,245,64.81,133,35.19
4119,41,19,443,350,79.01,93,20.99
4120,41,20,315,211,66.98,104,33.02
4121,41,21,452,297,65.71,155,34.29
4122,41,22,482,311,64.52,171,35.48
4123,41,23,396,262,66.16,134,33.84
4124,41,24,402,257,63.93,145,36.07
4125,41,25,377,249,66.05,128,33.95
4126,41,26,394,267,67.77,127,32.23
4127,41,27,368,246,66.85,122,33.15
4128,41,28,405,274,67.65,131,32.35
4129,41,29,337,232,68.84,105,31.16
4130,41,30,366,260,71.04,106,28.96
4131,41,31,383,281,73.37,102,26.63
4132,41,32,372,259,69.62,113,30.38
4133,41,33,398,263,66.08,135,33.92
4134,41,34,381,247,64.83,134,35.17
4135,41,35,483,306,63.35,177,36.65
4136,41,36,427,277,64.87,150,35.13
4137,41,37,479,359,74.95,120,25.05
4138,41,38,409,269,65.77,140,34.23
4139,41,39,424,272,64.15,152,35.85
4140,41,40,474,295,62.24,179,37.76
4141,41,41,444,311,70.05,133,29.95
4142,41,42,417,277,66.43,140,33.57
4143,41,43,404,271,67.08,133,32.92
4144,41,44,432,278,64.35,154,35.65
4145,41,45,420,287,68.33,133,31.67
4146,41,46,419,284,67.78,135,32.22
4147,41,47,419,290,69.21,129,30.79
4201,42,1,395,337,85.32,58,14.68
4202,42,2,589,500,84.89,89,15.11
4203,42,3,508,426,83.86,82,16.14
4204,42,4,1104,923,83.61,181,16.39
4205,42,5,389,328,84.32,61,15.68
4206,42,6,452,373,82.52,79,17.48
4207,42,7,561,468,83.42,93,16.58
4208,42,8,370,295,79.73,75,20.27
4209,42,9,659,543,82.4,116,17.6
4210,42,10,689,550,79.83,139,20.17
4211,42,11,311,264,84.89,47,15.11
4212,42,12,379,320,84.43,59,15.57
4213,42,13,382,316,82.72,66,17.28
4214,42,14,664,551,82.98,113,17.02
4215,42,15,643,529,82.27,114,17.73
4216,42,16,489,390,79.75,99,20.25
4217,42,17,762,633,83.07,129,16.93
4218,42,18,642,541,84.27,101,15.73
4219,42,19,585,494,84.44,91,15.56
4220,42,20,584,462,79.11,122,20.89
4221,42,21,620,525,84.68,95,15.32
4222,42,22,272,229,84.19,43,15.81
4223,42,23,490,398,81.22,92,18.78
4224,42,24,420,356,84.76,64,15.24
4225,42,25,563,434,77.09,129,22.91
4226,42,26,771,639,82.88,132,17.12
4227,42,27,336,246,73.21,90,26.79
4228,42,28,526,422,80.23,104,19.77
4229,42,29,579,459,79.27,120,20.73
4230,42,30,363,303,83.47,60,16.53
4231,42,31,553,446,80.65,107,19.35
4232,42,32,588,463,78.74,125,21.26
4233,42,33,565,444,78.58,121,21.42
4234,42,34,381,310,81.36,71,18.64
4235,42,35,592,477,80.57,115,19.43
4236,42,36,889,706,79.42,183,20.58
4237,42,37,373,314,84.18,59,15.82
4238,42,38,484,388,80.17,96,19.83
4239,42,39,866,745,86.03,121,13.97
4240,42,40,719,598,83.17,121,16.83
4241,42,41,516,415,80.43,101,19.57
4242,42,42,870,739,84.94,131,15.06
4301,43,1,244,204,83.61,40,16.39
4302,43,2,518,439,84.75,79,15.25
4303,43,3,453,384,84.77,69,15.23
4304,43,4,556,468,84.17,88,15.83
4305,43,5,439,379,86.33,60,13.67
4306,43,6,379,329,86.81,50,13.19
4307,43,7,280,248,88.57,32,11.43
4308,43,8,367,311,84.74,56,15.26
4309,43,9,467,396,84.8,71,15.2
4310,43,10,571,488,85.46,83,14.54
4311,43,11,449,393,87.53,56,12.47
4312,43,12,306,263,85.95,43,14.05
4313,43,13,487,414,85.01,73,14.99
4314,43,14,483,410,84.89,73,15.11
4315,43,15,467,381,81.58,86,18.42
4316,43,16,641,527,82.22,114,17.78
4317,43,17,388,341,87.89,47,12.11
4318,43,18,527,456,86.53,71,13.47
4319,43,19,470,414,88.09,56,11.91
4320,43,20,579,487,84.11,92,15.89
4321,43,21,545,450,82.57,95,17.43
4322,43,22,332,277,83.43,55,16.57
4323,43,23,344,297,86.34,47,13.66
4324,43,24,352,296,84.09,56,15.91
4325,43,25,400,331,82.75,69,17.25
4326,43,26,291,252,86.6,39,13.4
4327,43,27,450,384,85.33,66,14.67
4328,43,28,570,493,86.49,77,13.51
4329,43,29,667,571,85.61,96,14.39
4330,43,30,505,423,83.76,82,16.24
4331,43,31,445,360,80.9,85,19.1
4332,43,32,485,417,85.98,68,14.02
4333,43,33,439,382,87.02,57,12.98
4334,43,34,313,268,85.62,45,14.38
4335,43,35,494,418,84.62,76,15.38
4336,43,36,320,261,81.56,59,18.44
4337,43,37,562,470,83.63,92,16.37
4338,43,38,325,271,83.38,54,16.62
4339,43,39,355,276,77.75,79,22.25
4340,43,40,364,298,81.87,66,18.13
4341,43,41,579,496,85.66,83,14.34
4342,43,42,450,372,82.67,78,17.33
4343,43,43,449,389,86.64,60,13.36
4344,43,44,445,372,83.6,73,16.4
4345,43,45,296,250,84.46,46,15.54
4346,43,46,289,247,85.47,42,14.53
4401,44,1,797,652,81.81,145,18.19
4402,44,2,519,436,84.01,83,15.99
4403,44,3,273,234,85.71,39,14.29
4404,44,4,394,353,89.59,41,10.41
4405,44,5,523,434,82.98,89,17.02
4406,44,6,645,545,84.5,100,15.5
4407,44,7,306,254,83.01,52,16.99
4408,44,8,710,604,85.07,106,14.93
4409,44,9,547,468,85.56,79,14.44
4410,44,10,562,473,84.16,89,15.84
4411,44,11,612,486,79.41,126,20.59
4412,44,12,548,473,86.31,75,13.69
4413,44,13,462,392,84.85,70,15.15
4414,44,14,521,428,82.15,93,17.85
4415,44,15,485,404,83.3,81,16.7
4416,44,16,622,483,77.65,139,22.35
4417,44,17,694,569,81.99,125,18.01
4418,44,18,571,481,84.24,90,15.76
4419,44,19,617,512,82.98,105,17.02
4420,44,20,669,552,82.51,117,17.49
4421,44,21,614,515,83.88,99,16.12
4422,44,22,498,415,83.33,83,16.67
4423,44,23,514,444,86.38,70,13.62
4424,44,24,346,312,90.17,34,9.83
4425,44,25,540,449,83.15,91,16.85
4426,44,26,706,581,82.29,125,17.71
4427,44,27,607,510,84.02,97,15.98
4428,44,28,584,488,83.56,96,16.44
4429,44,29,619,532,85.95,87,14.05
4430,44,30,639,525,82.16,114,17.84
4431,44,31,487,402,82.55,85,17.45
4432,44,32,609,490,80.46,119,19.54
4433,44,33,605,502,82.98,103,17.02
4434,44,34,549,473,86.16,76,13.84
4435,44,35,543,461,84.9,82,15.1
4436,44,36,617,515,83.47,102,16.53
4437,44,37,604,494,81.79,110,18.21
4438,44,38,645,524,81.24,121,18.76
4439,44,39,590,517,87.63,73,12.37
4440,44,40,503,430,85.49,73,14.51
4441,44,41,695,558,80.29,137,19.71
4501,45,1,367,277,75.48,90,24.52
4502,45,2,437,347,79.41,90,20.59
4503,45,3,391,309,79.03,82,20.97
4504,45,4,512,382,74.61,130,25.39
4505,45,5,446,354,79.37,92,20.63
4506,45,6,587,449,76.49,138,23.51
4507,45,7,613,490,79.93,123,20.07
4508,45,8,446,329,73.77,117,26.23
4509,45,9,431,308,71.46,123,28.54
4510,45,10,414,298,71.98,116,28.02
4511,45,11,342,247,72.22,95,27.78
4512,45,12,380,266,70.0,114,30.0
4513,45,13,349,267,76.5,82,23.5
4514,45,14,614,461,75.08,153,24.92
4515,45,15,516,394,76.36,122,23.64
4516,45,16,353,266,75.35,87,24.65
4517,45,17,456,325,71.27,131,28.73
4518,45,18,461,344,74.62,117,25.38
4519,45,19,235,177,75.32,58,24.68
4520,45,20,294,207,70.41,87,29.59
4521,45,21,367,255,69.48,112,30.52
4522,45,22,382,284,74.35,98,25.65
4523,45,23,399,281,70.43,118,29.57
4524,45,24,332,227,68.37,105,31.63
4525,45,25,281,188,66.9,93,33.1
4526,45,26,237,171,72.15,66,27.85
4527,45,27,406,281,69.21,125,30.79
4528,45,28,339,242,71.39,97,28.61
4529,45,29,265,208,78.49,57,21.51
4530,45,30,420,307,73.1,113,26.9
4531,45,31,335,243,72.54,92,27.46
4532,45,32,393,287,73.03,106,26.97
4533,45,33,300,224,74.67,76,25.33
4534,45,34,440,320,72.73,120,27.27
4535,45,35,466,339,72.75,127,27.25
4536,45,36,437,315,72.08,122,27.92
4537,45,37,404,273,67.57,131,32.43
4538,45,38,404,285,70.54,119,29.46
4539,45,39,415,298,71.81,117,28.19
4540,45,40,390,266,68.21,124,31.79
4541,45,41,369,247,66.94,122,33.06
4542,45,42,397,282,71.03,115,28.97
4543,45,43,443,311,70.2,132,29.8
4544,45,44,376,267,71.01,109,28.99
4545,45,45,264,174,65.91,90,34.09
4546,45,46,336,222,66.07,114,33.93
4547,45,47,298,191,64.09,107,35.91
4548,45,48,316,207,65.51,109,34.49
4601,46,1,388,298,76.8,90,23.2
4602,46,2,504,390,77.38,114,22.62
4603,46,3,579,492,84.97,87,15.03
4604,46,4,488,393,80.53,95,19.47
4605,46,5,672,532,79.17,140,20.83
4606,46,6,430,330,76.74,100,23.26
4607,46,7,477,390,81.76,87,18.24
4608,46,8,335,246,73.43,89,26.57
4609,46,9,574,449,78.22,125,21.78
4610,46,10,872,733,84.06,139,15.94
4611,46,11,477,362,75.89,115,24.11
4612,46,12,547,438,80.07,109,19.93
4613,46,13,533,433,81.24,100,18.76
4614,46,14,523,389,74.38,134,25.62
4615,46,15,513,428,83.43,85,16.57
4616,46,16,578,464,80.28,114,19.72
4617,46,17,540,438,81.11,102,18.89
4618,46,18,570,435,76.32,135,23.68
4619,46,19,334,265,79.34,69,20.66
4620,46,20,433,355,81.99,78,18.01
4621,46,21,388,291,75.0,97,25.0
4622,46,22,358,270,75.42,88,24.58
4623,46,23,469,382,81.45,87,18.55
4624,46,24,638,526,82.45,112,17.55
4625,46,25,501,387,77.25,114,22.75
4626,46,26,710,541,76.2,169,23.8
4627,46,27,673,531,78.9,142,21.1
4628,46,28,466,393,84.33,73,15.67
4629,46,29,396,326,82.32,70,17.68
4630,46,30,533,429,80.49,104,19.51
4631,46,31,524,438,83.59,86,16.41
4632,46,32,479,364,75.99,115,24.01
4633,46,33,517,444,85.88,73,14.12
4634,46,34,665,542,81.5,123,18.5
4635,46,35,582,473,81.27,109,18.73
4636,46,36,475,395,83.16,80,16.84
4637,46,37,404,319,78.96,85,21.04
4638,46,38,584,464,79.45,120,20.55
4639,46,39,456,339,74.34,117,25.66
4640,46,40,430,344,80.0,86,20.0
4701,47,1,367,292,79.56,75,20.44
4702,47,2,512,431,84.18,81,15.82
4703,47,3,493,421,85.4,72,14.6
4704,47,4,628,534,85.03,94,14.97
4705,47,5,576,454,78.82,122,21.18
4706,47,6,636,540,84.91,96,15.09
4707,47,7,496,382,77.02,114,22.98
4708,47,8,533,432,81.05,101,18.95
4709,47,9,496,399,80.44,97,19.56
4710,47,10,644,517,80.28,127,19.72
4711,47,11,534,437,81.84,97,18.16
4712,47,12,576,467,81.08,109,18.92
4713,47,13,518,425,82.05,93,17.95
4714,47,14,485,420,86.6,65,13.4
4715,47,15,666,507,76.13,159,23.87
4716,47,16,526,438,83.27,88,16.73
4717,47,17,522,406,77.78,116,22.22
4718,47,18,514,407,79.18,107,20.82
4719,47,19,824,648,78.64,176,21.36
4720,47,20,560,461,82.32,99,17.68
4721,47,21,508,396,77.95,112,22.05
4722,47,22,578,468,80.97,110,19.03
4723,47,23,597,469,78.56,128,21.44
4724,47,24,550,445,80.91,105,19.09
4725,47,25,648,528,81.48,120,18.52
4726,47,26,724,596,82.32,128,17.68
4727,47,27,458,377,82.31,81,17.69
4728,47,28,499,397,79.56,102,20.44
4729,47,29,627,522,83.25,105,16.75
4730,47,30,667,546,81.86,121,18.14
4731,47,31,582,459,78.87,123,21.13
4732,47,32,650,531,81.69,119,18.31
4733,47,33,513,427,83.24,86,16.76
4734,47,34,564,472,83.69,92,16.31
4735,47,35,530,432,81.51,98,18.49
4736,47,36,623,490,78.65,133,21.35
4737,47,37,486,384,79.01,102,20.99
4738,47,38,532,438,82.33,94,17.67
4739,47,39,530,428,80.75,102,19.25
4740,47,40,504,420,83.33,84,16.67
4741,47,41,590,465,78.81,125,21.19
4742,47,42,517,402,77.76,115,22.24
4743,47,43,478,409,85.56,69,14.44
4744,47,44,452,375,82.96,77,17.04
4745,47,45,508,423,83.27,85,16.73
4746,47,46,549,447,81.42,102,18.58
4747,47,47,652,545,83.59,107,16.41
4748,47,48,33,24,72.73,9,27.27
4801,48,1,503,394,78.33,109,21.67
4802,48,2,209,178,85.17,31,14.83
4803,48,3,568,430,75.7,138,24.3
4804,48,4,448,360,80.36,88,19.64
4805,48,5,248,212,85.48,36,14.52
4806,48,6,580,465,80.17,115,19.83
4807,48,7,527,447,84.82,80,15.18
4808,48,8,250,200,80.0,50,20.0
4809,48,9,317,257,81.07,60,18.93
4810,48,10,700,588,84.0,112,16.0
4811,48,11,400,328,82.0,72,18.0
4812,48,12,586,459,78.33,127,21.67
4813,48,13,613,499,81.4,114,18.6
4814,48,14,200,161,80.5,39,19.5
4815,48,15,318,263,82.7,55,17.3
4816,48,16,546,414,75.82,132,24.18
4817,48,17,421,358,85.04,63,14.96
4818,48,18,327,251,76.76,76,23.24
4819,48,19,347,280,80.69,67,19.31
4820,48,20,539,406,75.32,133,24.68
4821,48,21,629,469,74.56,160,25.44
4822,48,22,363,298,82.09,65,17.91
4823,48,23,427,372,87.12,55,12.88
4824,48,24,568,384,67.61,184,32.39
4825,48,25,426,358,84.04,68,15.96
4826,48,26,239,188,78.66,51,21.34
4827,48,27,487,376,77.21,111,22.79
4828,48,28,506,388,76.68,118,23.32
4829,48,29,177,162,91.53,15,8.47
4830,48,30,416,332,79.81,84,20.19
4831,48,31,717,538,75.03,179,24.97
4832,48,32,534,413,77.34,121,22.66
4833,48,33,255,223,87.45,32,12.55
4834,48,34,413,331,80.15,82,19.85
4835,48,35,288,220,76.39,68,23.61
4836,48,36,274,232,84.67,42,15.33
4837,48,37,509,402,78.98,107,21.02
4838,48,38,499,425,85.17,74,14.83
4839,48,39,359,294,81.89,65,18.11
4840,48,40,448,363,81.03,85,18.97
4841,48,41,650,482,74.15,168,25.85
4842,48,42,578,466,80.62,112,19.38
4843,48,43,580,462,79.66,118,20.34
4844,48,44,634,518,81.7,116,18.3
4845,48,45,378,303,80.16,75,19.84
4846,48,46,277,229,82.67,48,17.33
4901,49,1,333,242,72.67,91,27.33
4902,49,2,309,248,80.26,61,19.74
4903,49,3,630,479,76.03,151,23.97
4904,49,4,676,501,74.11,175,25.89
4905,49,5,492,390,79.27,102,20.73
4906,49,6,433,335,77.37,98,22.63
4907,49,7,398,301,75.63,97,24.37
4908,49,8,450,367,81.56,83,18.44
4909,49,9,505,405,80.2,100,19.8
4910,49,10,586,452,77.13,134,22.87
4911,49,11,657,517,78.69,140,21.31
4912,49,12,626,497,79.39,129,20.61
4913,49,13,573,439,76.61,134,23.39
4914,49,14,388,301,77.58,87,22.42
4915,49,15,381,293,76.9,88,23.1
4916,49,16,450,346,76.89,104,23.11
4917,49,17,392,315,80.36,77,19.64
4918,49,18,645,498,77.21,147,22.79
4919,49,19,471,359,76.22,112,23.78
4920,49,20,754,577,76.53,177,23.47
4921,49,21,323,263,81.42,60,18.58
4922,49,22,530,404,76.23,126,23.77
4923,49,23,674,512,75.96,162,24.04
4924,49,24,396,314,79.29,82,20.71
4925,49,25,642,487,75.86,155,24.14
4926,49,26,571,436,76.36,135,23.64
4927,49,27,584,432,73.97,152,26.03
4928,49,28,725,532,73.38,193,26.62
4929,49,29,585,441,75.38,144,24.62
4930,49,30,524,403,76.91,121,23.09
4931,49,31,351,271,77.21,80,22.79
4932,49,32,492,345,70.12,147,29.88
4933,49,33,400,317,79.25,83,20.75
5001,50,1,314,247,78.66,67,21.34
5002,50,2,219,170,77.63,49,22.37
5003,50,3,284,223,78.52,61,21.48
5004,50,4,400,319,79.75,81,20.25
5005,50,5,201,161,80.1,40,19.9
5006,50,6,393,312,79.39,81,20.61
5007,50,7,480,394,82.08,86,17.92
5008,50,8,368,280,76.09,88,23.91
5009,50,9,305,230,75.41,75,24.59
5010,50,10,365,268,73.42,97,26.58
5011,50,11,176,130,73.86,46,26.14
5012,50,12,143,109,76.22,34,23.78
5013,50,13,456,356,78.07,100,21.93
5014,50,14,107,81,75.7,26,24.3
5015,50,15,474,384,81.01,90,18.99
5016,50,16,97,75,77.32,22,22.68
5017,50,17,367,298,81.2,69,18.8
5018,50,18,46,35,76.09,11,23.91
5019,50,19,317,252,79.5,65,20.5
5020,50,20,417,317,76.02,100,23.98
5021,50,21,342,260,76.02,82,23.98
5022,50,22,320,252,78.75,68,21.25
5023,50,23,246,181,73.58,65,26.42
5024,50,24,207,142,68.6,65,31.4
5025,50,25,284,201,70.77,83,29.23
5026,50,26,401,295,73.57,106,26.43
5027,50,27,99,69,69.7,30,30.3
5028,50,28,409,328,80.2,81,19.8
5029,50,29,396,310,78.28,86,21.72
5030,50,30,317,261,82.33,56,17.67
5031,50,31,541,415,76.71,126,23.29
5032,50,32,433,338,78.06,95,21.94
5033,50,33,221,175,79.19,46,20.81
5034,50,34,452,350,77.43,102,22.57
5035,50,35,523,425,81.26,98,18.74
5036,50,36,378,306,80.95,72,19.05
5037,50,37,395,319,80.76,76,19.24
5038,50,38,115,83,72.17,32,27.83
5039,50,39,221,172,77.83,49,22.17
5040,50,40,237,166,70.04,71,29.96
