id,ward,precinct,total,Yes,Yes Percent,No,No Percent
0101,1,1,710,638,89.86,72,10.14
0102,1,2,567,527,92.95,40,7.05
0103,1,3,795,712,89.56,83,10.44
0104,1,4,794,710,89.42,84,10.58
0105,1,5,715,623,87.13,92,12.87
0106,1,6,602,520,86.38,82,13.62
0107,1,7,463,407,87.9,56,12.1
0108,1,8,583,528,90.57,55,9.43
0109,1,9,456,421,92.32,35,7.68
0110,1,10,865,748,86.47,117,13.53
0111,1,11,792,697,88.01,95,11.99
0112,1,12,812,729,89.78,83,10.22
0113,1,13,329,301,91.49,28,8.51
0114,1,14,672,602,89.58,70,10.42
0115,1,15,610,555,90.98,55,9.02
0116,1,16,724,648,89.5,76,10.5
0117,1,17,575,523,90.96,52,9.04
0118,1,18,666,627,94.14,39,5.86
0119,1,19,782,708,90.54,74,9.46
0120,1,20,520,493,94.81,27,5.19
0121,1,21,989,881,89.08,108,10.92
0122,1,22,460,412,89.57,48,10.43
0123,1,23,861,795,92.33,66,7.67
0124,1,24,609,556,91.3,53,8.7
0125,1,25,658,606,92.1,52,7.9
0126,1,26,446,428,95.96,18,4.04
0127,1,27,764,661,86.52,103,13.48
0128,1,28,220,201,91.36,19,8.64
0129,1,29,874,778,89.02,96,10.98
0130,1,30,755,689,91.26,66,8.74
0131,1,31,618,561,90.78,57,9.22
0132,1,32,653,553,84.69,100,15.31
0133,1,33,756,662,87.57,94,12.43
0134,1,34,525,487,92.76,38,7.24
0135,1,35,837,721,86.14,116,13.86
0136,1,36,783,687,87.74,96,12.26
0137,1,37,714,618,86.55,96,13.45
0138,1,38,653,586,89.74,67,10.26
0139,1,39,551,492,89.29,59,10.71
0140,1,40,596,538,90.27,58,9.73
0141,1,41,390,352,90.26,38,9.74
0142,1,42,215,185,86.05,30,13.95
0143,1,43,427,375,87.82,52,12.18
0144,1,44,623,562,90.21,61,9.79
0201,2,1,766,687,89.69,79,10.31
0202,2,2,459,366,79.74,93,20.26
0203,2,3,785,701,89.3,84,10.7
0204,2,4,683,613,89.75,70,10.25
0205,2,5,820,716,87.32,104,12.68
0206,2,6,721,648,89.88,73,10.12
0207,2,7,634,553,87.22,81,12.78
0208,2,8,871,761,87.37,110,12.63
0209,2,9,647,521,80.53,126,19.47
0210,2,10,477,350,73.38,127,26.62
0211,2,11,660,507,76.82,153,23.18
0212,2,12,535,452,84.49,83,15.51
0213,2,13,538,411,76.39,127,23.61
0214,2,14,699,622,88.98,77,11.02
0215,2,15,617,543,88.01,74,11.99
0216,2,16,655,577,88.09,78,11.91
0217,2,17,751,654,87.08,97,12.92
0218,2,18,612,484,79.08,128,20.92
0219,2,19,421,318,75.53,103,24.47
0220,2,20,881,718,81.5,163,18.5
0221,2,21,721,659,91.4,62,8.6
0222,2,22,696,533,76.58,163,23.42
0223,2,23,428,331,77.34,97,22.66
0224,2,24,611,496,81.18,115,18.82
0225,2,25,776,657,84.66,119,15.34
0226,2,26,589,480,81.49,109,18.51
0227,2,27,572,418,73.08,154,26.92
0228,2,28,755,624,82.65,131,17.35
0229,2,29,748,594,79.41,154,20.59
0230,2,30,557,427,76.66,130,23.34
0231,2,31,706,552,78.19,154,21.81
0232,2,32,580,451,77.76,129,22.24
0233,2,33,909,711,78.22,198,21.78
0234,2,34,476,354,74.37,122,25.63
0235,2,35,860,726,84.42,134,15.58
0236,2,36,744,580,77.96,164,22.04
0237,2,37,541,449,82.99,92,17.01
0238,2,38,588,440,74.83,148,25.17
0239,2,39,462,362,78.35,100,21.65
0240,2,40,929,762,82.02,167,17.98
0241,2,41,788,625,79.31,163,20.69
0242,2,42,740,631,85.27,109,14.73
0243,2,43,889,698,78.52,191,21.48
0244,2,44,399,311,77.94,88,22.06
0245,2,45,771,658,85.34,113,14.66
0246,2,46,388,305,78.61,83,21.39
0301,3,1,762,743,97.51,19,2.49
0302,3,2,597,574,96.15,23,3.85
0303,3,3,493,454,92.09,39,7.91
0304,3,4,630,607,96.35,23,3.65
0305,3,5,331,315,95.17,16,4.83
0306,3,6,880,739,83.98,141,16.02
0307,3,7,344,324,94.19,20,5.81
0308,3,8,443,430,97.07,13,2.93
0309,3,9,662,642,96.98,20,3.02
0310,3,10,272,261,95.96,11,4.04
0311,3,11,624,609,97.6,15,2.4
0312,3,12,533,509,95.5,24,4.5
0313,3,13,734,636,86.65,98,13.35
0314,3,14,723,660,91.29,63,8.71
0315,3,15,517,499,96.52,18,3.48
0316,3,16,460,445,96.74,15,3.26
0317,3,17,898,833,92.76,65,7.24
0318,3,18,767,732,95.44,35,4.56
0319,3,19,777,642,82.63,135,17.37
0320,3,20,607,585,96.38,22,3.62
0321,3,21,652,522,80.06,130,19.94
0322,3,22,893,750,83.99,143,16.01
0323,3,23,485,451,92.99,34,7.01
0324,3,24,492,474,96.34,18,3.66
0325,3,25,1131,918,81.17,213,18.83
0326,3,26,706,577,81.73,129,18.27
0327,3,27,812,669,82.39,143,17.61
0328,3,28,316,304,96.2,12,3.8
0329,3,29,604,570,94.37,34,5.63
0330,3,30,484,465,96.07,19,3.93
0331,3,31,664,643,96.84,21,3.16
0332,3,32,1014,879,86.69,135,13.31
0333,3,33,791,681,86.09,110,13.91
0334,3,34,952,844,88.66,108,11.34
0335,3,35,304,286,94.08,18,5.92
0336,3,36,265,259,97.74,6,2.26
0337,3,37,506,491,97.04,15,2.96
0338,3,38,397,391,98.49,6,1.51
0339,3,39,1257,1089,86.63,168,13.37
0340,3,40,644,594,92.24,50,7.76
0341,3,41,404,376,93.07,28,6.93
0401,4,1,875,814,93.03,61,6.97
0402,4,2,845,728,86.15,117,13.85
0403,4,3,489,477,97.55,12,2.45
0404,4,4,761,735,96.58,26,3.42
0405,4,5,614,588,95.77,26,4.23
0406,4,6,647,614,94.9,33,5.1
0407,4,7,743,717,96.5,26,3.5
0408,4,8,655,646,98.63,9,1.37
0409,4,9,638,628,98.43,10,1.57
0410,4,10,766,729,95.17,37,4.83
0411,4,11,608,582,95.72,26,4.28
0412,4,12,766,742,96.87,24,3.13
0413,4,13,870,779,89.54,91,10.46
0414,4,14,603,577,95.69,26,4.31
0415,4,15,661,643,97.28,18,2.72
0416,4,16,1135,998,87.93,137,12.07
0417,4,17,743,658,88.56,85,11.44
0418,4,18,559,536,95.89,23,4.11
0419,4,19,445,425,95.51,20,4.49
0420,4,20,523,448,85.66,75,14.34
0421,4,21,716,622,86.87,94,13.13
0422,4,22,588,531,90.31,57,9.69
0423,4,23,738,693,93.9,45,6.1
0424,4,24,567,531,93.65,36,6.35
0425,4,25,828,706,85.27,122,14.73
0426,4,26,525,500,95.24,25,4.76
0427,4,27,801,762,95.13,39,4.87
0428,4,28,527,508,96.39,19,3.61
0429,4,29,545,535,98.17,10,1.83
0430,4,30,805,780,96.89,25,3.11
0431,4,31,553,542,98.01,11,1.99
0432,4,32,664,637,95.93,27,4.07
0433,4,33,573,540,94.24,33,5.76
0434,4,34,532,511,96.05,21,3.95
0435,4,35,689,659,95.65,30,4.35
0436,4,36,735,703,95.65,32,4.35
0437,4,37,1216,1054,86.68,162,13.32
0438,4,38,651,631,96.93,20,3.07
0501,5,1,518,498,96.14,20,3.86
0502,5,2,407,396,97.3,11,2.7
0503,5,3,573,537,93.72,36,6.28
0504,5,4,745,713,95.7,32,4.3
0505,5,5,498,484,97.19,14,2.81
0506,5,6,436,423,97.02,13,2.98
0507,5,7,551,526,95.46,25,4.54
0508,5,8,588,521,88.61,67,11.39
0509,5,9,662,632,95.47,30,4.53
0510,5,10,457,444,97.16,13,2.84
0511,5,11,557,515,92.46,42,7.54
0512,5,12,355,345,97.18,10,2.82
0513,5,13,483,466,96.48,17,3.52
0514,5,14,438,429,97.95,9,2.05
0515,5,15,557,523,93.9,34,6.1
0516,5,16,523,505,96.56,18,3.44
0517,5,17,455,434,95.38,21,4.62
0518,5,18,518,498,96.14,20,3.86
0519,5,19,515,483,93.79,32,6.21
0520,5,20,618,590,95.47,28,4.53
0521,5,21,567,537,94.71,30,5.29
0522,5,22,670,632,94.33,38,5.67
0523,5,23,977,876,89.66,101,10.34
0524,5,24,703,647,92.03,56,7.97
0525,5,25,473,459,97.04,14,2.96
0526,5,26,535,527,98.5,8,1.5
0527,5,27,575,498,86.61,77,13.39
0528,5,28,561,536,95.54,25,4.46
0529,5,29,559,539,96.42,20,3.58
0530,5,30,363,353,97.25,10,2.75
0531,5,31,423,413,97.64,10,2.36
0532,5,32,607,590,97.2,17,2.8
0533,5,33,507,491,96.84,16,3.16
0534,5,34,600,513,85.5,87,14.5
0535,5,35,714,670,93.84,44,6.16
0536,5,36,331,320,96.68,11,3.32
0537,5,37,572,540,94.41,32,5.59
0538,5,38,514,497,96.69,17,3.31
0539,5,39,460,405,88.04,55,11.96
0540,5,40,415,402,96.87,13,3.13
0541,5,41,252,235,93.25,17,6.75
0601,6,1,462,451,97.62,11,2.38
0602,6,2,450,440,97.78,10,2.22
0603,6,3,446,434,97.31,12,2.69
0604,6,4,312,296,94.87,16,5.13
0605,6,5,280,263,93.93,17,6.07
0606,6,6,516,501,97.09,15,2.91
0607,6,7,441,423,95.92,18,4.08
0608,6,8,446,437,97.98,9,2.02
0609,6,9,449,429,95.55,20,4.45
0610,6,10,314,302,96.18,12,3.82
0611,6,11,381,370,97.11,11,2.89
0612,6,12,335,323,96.42,12,3.58
0613,6,13,329,318,96.66,11,3.34
0614,6,14,392,381,97.19,11,2.81
0615,6,15,393,370,94.15,23,5.85
0616,6,16,439,422,96.13,17,3.87
0617,6,17,312,296,94.87,16,5.13
0618,6,18,320,311,97.19,9,2.81
0619,6,19,356,342,96.07,14,3.93
0620,6,20,299,292,97.66,7,2.34
0621,6,21,223,213,95.52,10,4.48
0622,6,22,275,264,96.0,11,4.0
0623,6,23,248,236,95.16,12,4.84
0624,6,24,237,220,92.83,17,7.17
0625,6,25,230,216,93.91,14,6.09
0626,6,26,322,306,95.03,16,4.97
0627,6,27,269,264,98.14,5,1.86
0628,6,28,219,210,95.89,9,4.11
0629,6,29,462,449,97.19,13,2.81
0630,6,30,370,354,95.68,16,4.32
0631,6,31,394,383,97.21,11,2.79
0632,6,32,433,422,97.46,11,2.54
0633,6,33,436,417,95.64,19,4.36
0634,6,34,437,421,96.34,16,3.66
0635,6,35,404,393,97.28,11,2.72
0636,6,36,477,459,96.23,18,3.77
0637,6,37,471,453,96.18,18,3.82
0638,6,38,488,477,97.75,11,2.25
0639,6,39,363,348,95.87,15,4.13
0640,6,40,390,379,97.18,11,2.82
0641,6,41,439,424,96.58,15,3.42
0642,6,42,434,426,98.16,8,1.84
0643,6,43,418,409,97.85,9,2.15
0644,6,44,484,471,97.31,13,2.69
0645,6,45,445,429,96.4,16,3.6
0646,6,46,323,311,96.28,12,3.72
0647,6,47,302,291,96.36,11,3.64
0648,6,48,428,406,94.86,22,5.14
0701,7,1,436,417,95.64,19,4.36
0702,7,2,433,417,96.3,16,3.7
0703,7,3,418,410,98.09,8,1.91
0704,7,4,419,413,98.57,6,1.43
0705,7,5,386,364,94.3,22,5.7
0706,7,6,547,524,95.8,23,4.2
0707,7,7,409,395,96.58,14,3.42
0708,7,8,293,282,96.25,11,3.75
0709,7,9,710,686,96.62,24,3.38
0710,7,10,415,406,97.83,9,2.17
0711,7,11,486,478,98.35,8,1.65
0712,7,12,423,414,97.87,9,2.13
0713,7,13,253,249,98.42,4,1.58
0714,7,14,489,462,94.48,27,5.52
0715,7,15,405,389,96.05,16,3.95
0716,7,16,402,386,96.02,16,3.98
0717,7,17,336,328,97.62,8,2.38
0718,7,18,394,380,96.45,14,3.55
0719,7,19,397,390,98.24,7,1.76
0720,7,20,335,329,98.21,6,1.79
0721,7,21,325,311,95.69,14,4.31
0722,7,22,357,340,95.24,17,4.76
0723,7,23,378,367,97.09,11,2.91
0724,7,24,337,323,95.85,14,4.15
0725,7,25,338,320,94.67,18,5.33
0726,7,26,319,303,94.98,16,5.02
0727,7,27,321,315,98.13,6,1.87
0728,7,28,310,290,93.55,20,6.45
0729,7,29,376,364,96.81,12,3.19
0730,7,30,336,323,96.13,13,3.87
0731,7,31,310,298,96.13,12,3.87
0732,7,32,505,497,98.42,8,1.58
0733,7,33,512,505,98.63,7,1.37
0734,7,34,502,486,96.81,16,3.19
0735,7,35,453,440,97.13,13,2.87
0736,7,36,518,509,98.26,9,1.74
0737,7,37,428,415,96.96,13,3.04
0738,7,38,367,357,97.28,10,2.72
0739,7,39,376,367,97.61,9,2.39
0740,7,40,343,330,96.21,13,3.79
0741,7,41,381,366,96.06,15,3.94
0742,7,42,384,378,98.44,6,1.56
0743,7,43,391,380,97.19,11,2.81
0744,7,44,361,351,97.23,10,2.77
0745,7,45,408,389,95.34,19,4.66
0746,7,46,119,115,96.64,4,3.36
0801,8,1,387,374,96.64,13,3.36
0802,8,2,405,392,96.79,13,3.21
0803,8,3,464,454,97.84,10,2.16
0804,8,4,476,463,97.27,13,2.73
0805,8,5,365,357,97.81,8,2.19
0806,8,6,419,407,97.14,12,2.86
0807,8,7,487,475,97.54,12,2.46
0808,8,8,435,426,97.93,9,2.07
0809,8,9,286,274,95.8,12,4.2
0810,8,10,538,522,97.03,16,2.97
0811,8,11,359,344,95.82,15,4.18
0812,8,12,382,373,97.64,9,2.36
0813,8,13,500,488,97.6,12,2.4
0814,8,14,361,350,96.95,11,3.05
0815,8,15,262,253,96.56,9,3.44
0816,8,16,132,123,93.18,9,6.82
0817,8,17,363,350,96.42,13,3.58
0818,8,18,421,403,95.72,18,4.28
0819,8,19,477,463,97.06,14,2.94
0820,8,20,503,489,97.22,14,2.78
0821,8,21,562,545,96.98,17,3.02
0822,8,22,382,371,97.12,11,2.88
0823,8,23,323,310,95.98,13,4.02
0824,8,24,237,230,97.05,7,2.95
0825,8,25,427,407,95.32,20,4.68
0826,8,26,369,364,98.64,5,1.36
0827,8,27,480,465,96.88,15,3.13
0828,8,28,439,425,96.81,14,3.19
0829,8,29,477,462,96.86,15,3.14
0830,8,30,476,466,97.9,10,2.1
0831,8,31,342,329,96.2,13,3.8
0832,8,32,338,332,98.22,6,1.78
0833,8,33,341,330,96.77,11,3.23
0834,8,34,380,366,96.32,14,3.68
0835,8,35,492,471,95.73,21,4.27
0836,8,36,432,418,96.76,14,3.24
0837,8,37,344,337,97.97,7,2.03
0838,8,38,306,296,96.73,10,3.27
0839,8,39,419,412,98.33,7,1.67
0840,8,40,357,347,97.2,10,2.8
0841,8,41,465,443,95.27,22,4.73
0842,8,42,557,538,96.59,19,3.41
0843,8,43,251,238,94.82,13,5.18
0844,8,44,312,303,97.12,9,2.88
0845,8,45,373,354,94.91,19,5.09
0846,8,46,343,340,99.13,3,0.87
0847,8,47,355,341,96.06,14,3.94
0848,8,48,393,383,97.46,10,2.54
0849,8,49,399,384,96.24,15,3.76
0850,8,50,434,424,97.7,10,2.3
0851,8,51,420,410,97.62,10,2.38
0852,8,52,536,525,97.95,11,2.05
0853,8,53,260,254,97.69,6,2.31
0854,8,54,360,345,95.83,15,4.17
0855,8,55,349,340,97.42,9,2.58
0856,8,56,447,434,97.09,13,2.91
0901,9,1,395,380,96.2,15,3.8
0902,9,2,338,323,95.56,15,4.44
0903,9,3,268,254,94.78,14,5.22
0904,9,4,325,319,98.15,6,1.85
0905,9,5,409,404,98.78,5,1.22
0906,9,6,377,361,95.76,16,4.24
0907,9,7,318,310,97.48,8,2.52
0908,9,8,436,428,98.17,8,1.83
0909,9,9,483,469,97.1,14,2.9
0910,9,10,325,311,95.69,14,4.31
0911,9,11,297,278,93.6,19,6.4
0912,9,12,462,447,96.75,15,3.25
0913,9,13,463,449,96.98,14,3.02
0914,9,14,465,454,97.63,11,2.37
0915,9,15,447,428,95.75,19,4.25
0916,9,16,395,389,98.48,6,1.52
0917,9,17,306,298,97.39,8,2.61
0918,9,18,296,288,97.3,8,2.7
0919,9,19,414,408,98.55,6,1.45
0920,9,20,372,358,96.24,14,3.76
0921,9,21,380,368,96.84,12,3.16
0922,9,22,448,439,97.99,9,2.01
0923,9,23,453,442,97.57,11,2.43
0924,9,24,404,385,95.3,19,4.7
0925,9,25,359,348,96.94,11,3.06
0926,9,26,378,362,95.77,16,4.23
0927,9,27,337,323,95.85,14,4.15
0928,9,28,267,257,96.25,10,3.75
0929,9,29,366,358,97.81,8,2.19
0930,9,30,357,348,97.48,9,2.52
0931,9,31,342,333,97.37,9,2.63
0932,9,32,414,401,96.86,13,3.14
0933,9,33,303,291,96.04,12,3.96
0934,9,34,341,327,95.89,14,4.11
0935,9,35,373,367,98.39,6,1.61
0936,9,36,342,331,96.78,11,3.22
0937,9,37,633,573,90.52,60,9.48
0938,9,38,394,384,97.46,10,2.54
0939,9,39,433,423,97.69,10,2.31
0940,9,40,453,445,98.23,8,1.77
0941,9,41,341,336,98.53,5,1.47
0942,9,42,437,420,96.11,17,3.89
0943,9,43,378,366,96.83,12,3.17
0944,9,44,369,359,97.29,10,2.71
0945,9,45,301,288,95.68,13,4.32
0946,9,46,381,362,95.01,19,4.99
0947,9,47,431,424,98.38,7,1.62
0948,9,48,426,418,98.12,8,1.88
0949,9,49,451,433,96.01,18,3.99
0950,9,50,571,559,97.9,12,2.1
0951,9,51,404,388,96.04,16,3.96
1001,10,1,334,309,92.51,25,7.49
1002,10,2,463,360,77.75,103,22.25
1003,10,3,485,385,79.38,100,20.62
1004,10,4,351,334,95.16,17,4.84
1005,10,5,371,304,81.94,67,18.06
1006,10,6,378,345,91.27,33,8.73
1007,10,7,323,293,90.71,30,9.29
1008,10,8,224,214,95.54,10,4.46
1009,10,9,442,343,77.6,99,22.4
1010,10,10,494,428,86.64,66,13.36
1011,10,11,576,525,91.15,51,8.85
1012,10,12,323,291,90.09,32,9.91
1013,10,13,399,371,92.98,28,7.02
1014,10,14,569,499,87.7,70,12.3
1015,10,15,759,738,97.23,21,2.77
1016,10,16,361,306,84.76,55,15.24
1017,10,17,593,464,78.25,129,21.75
1018,10,18,259,246,94.98,13,5.02
1019,10,19,476,401,84.24,75,15.76
1020,10,20,476,416,87.39,60,12.61
1021,10,21,459,412,89.76,47,10.24
1022,10,22,264,248,93.94,16,6.06
1023,10,23,395,371,93.92,24,6.08
1024,10,24,444,335,75.45,109,24.55
1025,10,25,134,131,97.76,3,2.24
1026,10,26,327,311,95.11,16,4.89
1027,10,27,372,355,95.43,17,4.57
1028,10,28,515,476,92.43,39,7.57
1029,10,29,472,433,91.74,39,8.26
1030,10,30,392,357,91.07,35,8.93
1031,10,31,379,365,96.31,14,3.69
1032,10,32,477,418,87.63,59,12.37
1033,10,33,348,322,92.53,26,7.47
1034,10,34,310,300,96.77,10,3.23
1035,10,35,482,383,79.46,99,20.54
1036,10,36,106,98,92.45,8,7.55
1101,11,1,523,442,84.51,81,15.49
1102,11,2,38,32,84.21,6,15.79
1103,11,3,566,523,92.4,43,7.6
1104,11,4,417,363,87.05,54,12.95
1105,11,5,721,632,87.66,89,12.34
1106,11,6,877,764,87.12,113,12.88
1107,11,7,535,473,88.41,62,11.59
1108,11,8,508,426,83.86,82,16.14
1109,11,9,475,400,84.21,75,15.79
1110,11,10,528,426,80.68,102,19.32
1111,11,11,619,500,80.78,119,19.22
1112,11,12,703,459,65.29,244,34.71
1113,11,13,662,438,66.16,224,33.84
1114,11,14,303,234,77.23,69,22.77
1115,11,15,215,182,84.65,33,15.35
1116,11,16,391,309,79.03,82,20.97
1117,11,17,653,535,81.93,118,18.07
1118,11,18,446,351,78.7,95,21.3
1119,11,19,734,640,87.19,94,12.81
1120,11,20,394,311,78.93,83,21.07
1121,11,21,650,445,68.46,205,31.54
1122,11,22,676,551,81.51,125,18.49
1123,11,23,303,226,74.59,77,25.41
1124,11,24,587,409,69.68,178,30.32
1125,11,25,687,562,81.8,125,18.2
1126,11,26,569,455,79.96,114,20.04
1127,11,27,223,191,85.65,32,14.35
1128,11,28,256,195,76.17,61,23.83
1129,11,29,653,458,70.14,195,29.86
1130,11,30,307,250,81.43,57,18.57
1131,11,31,537,374,69.65,163,30.35
1132,11,32,242,152,62.81,90,37.19
1133,11,33,727,607,83.49,120,16.51
1134,11,34,177,127,71.75,50,28.25
1135,11,35,114,92,80.7,22,19.3
1136,11,36,258,218,84.5,40,15.5
1137,11,37,181,166,91.71,15,8.29
1138,11,38,289,262,90.66,27,9.34
1201,12,1,465,417,89.68,48,10.32
1202,12,2,406,377,92.86,29,7.14
1203,12,3,579,498,86.01,81,13.99
1204,12,4,546,487,89.19,59,10.81
1205,12,5,446,370,82.96,76,17.04
1206,12,6,565,513,90.8,52,9.2
1207,12,7,443,424,95.71,19,4.29
1208,12,8,491,437,89.0,54,11.0
1209,12,9,395,361,91.39,34,8.61
1210,12,10,623,598,95.99,25,4.01
1211,12,11,526,496,94.3,30,5.7
1212,12,12,481,440,91.48,41,8.52
1213,12,13,532,489,91.92,43,8.08
1214,12,14,397,380,95.72,17,4.28
1215,12,15,432,408,94.44,24,5.56
1216,12,16,416,395,94.95,21,5.05
1217,12,17,557,516,92.64,41,7.36
1218,12,18,422,402,95.26,20,4.74
1219,12,19,466,421,90.34,45,9.66
1220,12,20,560,531,94.82,29,5.18
1221,12,21,509,454,89.19,55,10.81
1222,12,22,446,433,97.09,13,2.91
1223,12,23,497,447,89.94,50,10.06
1301,13,1,412,313,75.97,99,24.03
1302,13,2,331,245,74.02,86,25.98
1303,13,3,351,330,94.02,21,5.98
1304,13,4,466,334,71.67,132,28.33
1305,13,5,502,452,90.04,50,9.96
1306,13,6,383,238,62.14,145,37.86
1307,13,7,360,313,86.94,47,13.06
1308,13,8,331,243,73.41,88,26.59
1309,13,9,456,402,88.16,54,11.84
1310,13,10,359,209,58.22,150,41.78
1311,13,11,453,337,74.39,116,25.61
1312,13,12,393,336,85.5,57,14.5
1313,13,13,400,350,87.5,50,12.5
1314,13,14,417,356,85.37,61,14.63
1315,13,15,578,520,89.97,58,10.03
1316,13,16,309,284,91.91,25,8.09
1317,13,17,368,284,77.17,84,22.83
1318,13,18,347,246,70.89,101,29.11
1319,13,19,538,513,95.35,25,4.65
1320,13,20,296,202,68.24,94,31.76
1321,13,21,479,312,65.14,167,34.86
1322,13,22,472,317,67.16,155,32.84
1323,13,23,350,306,87.43,44,12.57
1324,13,24,411,346,84.18,65,15.82
1325,13,25,419,363,86.63,56,13.37
1326,13,26,422,339,80.33,83,19.67
1327,13,27,390,311,79.74,79,20.26
1328,13,28,322,291,90.37,31,9.63
1329,13,29,343,292,85.13,51,14.87
1330,13,30,329,305,92.71,24,7.29
1331,13,31,469,313,66.74,156,33.26
1332,13,32,362,239,66.02,123,33.98
1333,13,33,401,292,72.82,109,27.18
1334,13,34,412,385,93.45,27,6.55
1335,13,35,353,317,89.8,36,10.2
1336,13,36,301,270,89.7,31,10.3
1337,13,37,411,372,90.51,39,9.49
1338,13,38,360,231,64.17,129,35.83
1339,13,39,397,356,89.67,41,10.33
1340,13,40,403,346,85.86,57,14.14
1341,13,41,483,456,94.41,27,5.59
1342,13,42,435,258,59.31,177,40.69
1343,13,43,398,325,81.66,73,18.34
1344,13,44,410,381,92.93,29,7.07
1345,13,45,433,330,76.21,103,23.79
1346,13,46,484,439,90.7,45,9.3
1347,13,47,466,426,91.42,40,8.58
1348,13,48,358,252,70.39,106,29.61
1401,14,1,493,313,63.49,180,36.51
1402,14,2,622,566,91.0,56,9.0
1403,14,3,449,422,93.99,27,6.01
1404,14,4,479,293,61.17,186,38.83
1405,14,5,638,607,95.14,31,4.86
1406,14,6,243,232,95.47,11,4.53
1407,14,7,600,541,90.17,59,9.83
1408,14,8,565,515,91.15,50,8.85
1409,14,9,595,436,73.28,159,26.72
1410,14,10,332,298,89.76,34,10.24
1411,14,11,270,254,94.07,16,5.93
1412,14,12,490,430,87.76,60,12.24
1413,14,13,426,396,92.96,30,7.04
1414,14,14,430,411,95.58,19,4.42
1415,14,15,469,452,96.38,17,3.62
1416,14,16,340,315,92.65,25,7.35
1417,14,17,401,370,92.27,31,7.73
1418,14,18,224,191,85.27,33,14.73
1419,14,19,433,399,92.15,34,7.85
1420,14,20,364,345,94.78,19,5.22
1421,14,21,443,407,91.87,36,8.13
1422,14,22,649,562,86.59,87,13.41
1423,14,23,335,280,83.58,55,16.42
1424,14,24,538,378,70.26,160,29.74
1425,14,25,249,223,89.56,26,10.44
1426,14,26,352,331,94.03,21,5.97
1427,14,27,455,415,91.21,40,8.79
1428,14,28,385,359,93.25,26,6.75
1429,14,29,348,326,93.68,22,6.32
1430,14,30,313,300,95.85,13,4.15
1431,14,31,254,240,94.49,14,5.51
1501,15,1,385,361,93.77,24,6.23
1502,15,2,246,235,95.53,11,4.47
1503,15,3,269,263,97.77,6,2.23
1504,15,4,451,430,95.34,21,4.66
1505,15,5,410,383,93.41,27,6.59
1506,15,6,467,434,92.93,33,7.07
1507,15,7,246,238,96.75,8,3.25
1508,15,8,445,410,92.13,35,7.87
1509,15,9,599,560,93.49,39,6.51
1510,15,10,603,552,91.54,51,8.46
1511,15,11,537,498,92.74,39,7.26
1512,15,12,548,509,92.88,39,7.12
1513,15,13,441,419,95.01,22,4.99
1514,15,14,393,375,95.42,18,4.58
1515,15,15,391,373,95.4,18,4.6
1516,15,16,496,467,94.15,29,5.85
1517,15,17,249,239,95.98,10,4.02
1518,15,18,194,187,96.39,7,3.61
1519,15,19,378,356,94.18,22,5.82
1520,15,20,255,245,96.08,10,3.92
1521,15,21,212,205,96.7,7,3.3
1522,15,22,247,235,95.14,12,4.86
1523,15,23,264,256,96.97,8,3.03
1524,15,24,256,243,94.92,13,5.08
1601,16,1,543,518,95.4,25,4.6
1602,16,2,315,296,93.97,19,6.03
1603,16,3,293,280,95.56,13,4.44
1604,16,4,362,345,95.3,17,4.7
1605,16,5,244,231,94.67,13,5.33
1606,16,6,300,293,97.67,7,2.33
1607,16,7,335,321,95.82,14,4.18
1608,16,8,226,222,98.23,4,1.77
1609,16,9,316,304,96.2,12,3.8
1610,16,10,277,269,97.11,8,2.89
1611,16,11,334,322,96.41,12,3.59
1612,16,12,295,281,95.25,14,4.75
1613,16,13,401,387,96.51,14,3.49
1614,16,14,257,245,95.33,12,4.67
1615,16,15,313,298,95.21,15,4.79
1616,16,16,263,254,96.58,9,3.42
1617,16,17,454,443,97.58,11,2.42
1618,16,18,395,381,96.46,14,3.54
1619,16,19,320,304,95.0,16,5.0
1620,16,20,236,226,95.76,10,4.24
1621,16,21,288,275,95.49,13,4.51
1622,16,22,260,250,96.15,10,3.85
1623,16,23,457,442,96.72,15,3.28
1624,16,24,154,143,92.86,11,7.14
1625,16,25,386,365,94.56,21,5.44
1626,16,26,231,218,94.37,13,5.63
1627,16,27,239,231,96.65,8,3.35
1628,16,28,270,262,97.04,8,2.96
1629,16,29,262,256,97.71,6,2.29
1630,16,30,242,230,95.04,12,4.96
1631,16,31,313,299,95.53,14,4.47
1632,16,32,449,421,93.76,28,6.24
1633,16,33,252,244,96.83,8,3.17
1634,16,34,276,266,96.38,10,3.62
1635,16,35,490,467,95.31,23,4.69
1636,16,36,221,216,97.74,5,2.26
1701,17,1,453,429,94.7,24,5.3
1702,17,2,378,368,97.35,10,2.65
1703,17,3,396,374,94.44,22,5.56
1704,17,4,440,427,97.05,13,2.95
1705,17,5,294,285,96.94,9,3.06
1706,17,6,405,391,96.54,14,3.46
1707,17,7,405,381,94.07,24,5.93
1708,17,8,288,278,96.53,10,3.47
1709,17,9,287,280,97.56,7,2.44
1710,17,10,508,479,94.29,29,5.71
1711,17,11,302,292,96.69,10,3.31
1712,17,12,567,539,95.06,28,4.94
1713,17,13,291,277,95.19,14,4.81
1714,17,14,444,421,94.82,23,5.18
1715,17,15,394,388,98.48,6,1.52
1716,17,16,460,442,96.09,18,3.91
1717,17,17,405,395,97.53,10,2.47
1718,17,18,441,426,96.6,15,3.4
1719,17,19,234,223,95.3,11,4.7
1720,17,20,476,467,98.11,9,1.89
1721,17,21,450,442,98.22,8,1.78
1722,17,22,367,352,95.91,15,4.09
1723,17,23,252,244,96.83,8,3.17
1724,17,24,296,290,97.97,6,2.03
1725,17,25,309,300,97.09,9,2.91
1726,17,26,383,375,97.91,8,2.09
1727,17,27,233,231,99.14,2,0.86
1728,17,28,299,281,93.98,18,6.02
1729,17,29,376,361,96.01,15,3.99
1730,17,30,395,374,94.68,21,5.32
1731,17,31,234,227,97.01,7,2.99
1732,17,32,309,301,97.41,8,2.59
1733,17,33,219,199,90.87,20,9.13
1734,17,34,270,266,98.52,4,1.48
1735,17,35,266,261,98.12,5,1.88
1736,17,36,259,248,95.75,11,4.25
1737,17,37,310,293,94.52,17,5.48
1738,17,38,418,397,94.98,21,5.02
1739,17,39,396,381,96.21,15,3.79
1740,17,40,413,397,96.13,16,3.87
1741,17,41,506,493,97.43,13,2.57
1801,18,1,422,408,96.68,14,3.32
1802,18,2,502,458,91.24,44,8.76
1803,18,3,409,343,83.86,66,16.14
1804,18,4,468,454,97.01,14,2.99
1805,18,5,267,261,97.75,6,2.25
1806,18,6,416,350,84.13,66,15.87
1807,18,7,453,416,91.83,37,8.17
1808,18,8,433,419,96.77,14,3.23
1809,18,9,412,396,96.12,16,3.88
1810,18,10,544,533,97.98,11,2.02
1811,18,11,410,378,92.2,32,7.8
1812,18,12,411,398,96.84,13,3.16
1813,18,13,483,459,95.03,24,4.97
1814,18,14,444,434,97.75,10,2.25
1815,18,15,501,463,92.42,38,7.58
1816,18,16,413,401,97.09,12,2.91
1817,18,17,446,422,94.62,24,5.38
1818,18,18,338,333,98.52,5,1.48
1819,18,19,378,369,97.62,9,2.38
1820,18,20,311,301,96.78,10,3.22
1821,18,21,557,533,95.69,24,4.31
1822,18,22,478,467,97.7,11,2.3
1823,18,23,440,421,95.68,19,4.32
1824,18,24,435,388,89.2,47,10.8
1825,18,25,476,407,85.5,69,14.5
1826,18,26,530,516,97.36,14,2.64
1827,18,27,378,363,96.03,15,3.97
1828,18,28,442,351,79.41,91,20.59
1829,18,29,504,468,92.86,36,7.14
1830,18,30,553,470,84.99,83,15.01
1831,18,31,469,459,97.87,10,2.13
1832,18,32,436,419,96.1,17,3.9
1833,18,33,320,304,95.0,16,5.0
1834,18,34,485,462,95.26,23,4.74
1835,18,35,495,481,97.17,14,2.83
1836,18,36,481,444,92.31,37,7.69
1837,18,37,494,484,97.98,10,2.02
1838,18,38,394,385,97.72,9,2.28
1839,18,39,382,372,97.38,10,2.62
1840,18,40,490,450,91.84,40,8.16
1841,18,41,510,487,95.49,23,4.51
1842,18,42,389,376,96.66,13,3.34
1843,18,43,383,332,86.68,51,13.32
1844,18,44,407,323,79.36,84,20.64
1845,18,45,464,438,94.4,26,5.6
1846,18,46,506,430,84.98,76,15.02
1847,18,47,340,327,96.18,13,3.82
1848,18,48,313,303,96.81,10,3.19
1849,18,49,302,294,97.35,8,2.65
1850,18,50,330,312,94.55,18,5.45
1901,19,1,444,251,56.53,193,43.47
1902,19,2,643,558,86.78,85,13.22
1903,19,3,423,168,39.72,255,60.28
1904,19,4,596,283,47.48,313,52.52
1905,19,5,555,441,79.46,114,20.54
1906,19,6,548,284,51.82,264,48.18
1907,19,7,458,312,68.12,146,31.88
1908,19,8,578,264,45.67,314,54.33
1909,19,9,351,189,53.85,162,46.15
1910,19,10,613,499,81.4,114,18.6
1911,19,11,495,212,42.83,283,57.17
1912,19,12,433,202,46.65,231,53.35
1913,19,13,579,549,94.82,30,5.18
1914,19,14,531,448,84.37,83,15.63
1915,19,15,675,332,49.19,343,50.81
1916,19,16,499,230,46.09,269,53.91
1917,19,17,424,240,56.6,184,43.4
1918,19,18,489,361,73.82,128,26.18
1919,19,19,621,503,81.0,118,19.0
1920,19,20,406,363,89.41,43,10.59
1921,19,21,534,254,47.57,280,52.43
1922,19,22,539,391,72.54,148,27.46
1923,19,23,514,300,58.37,214,41.63
1924,19,24,368,159,43.21,209,56.79
1925,19,25,477,336,70.44,141,29.56
1926,19,26,501,353,70.46,148,29.54
1927,19,27,476,423,88.87,53,11.13
1928,19,28,569,545,95.78,24,4.22
1929,19,29,551,304,55.17,247,44.83
1930,19,30,498,253,50.8,245,49.2
1931,19,31,464,325,70.04,139,29.96
1932,19,32,440,242,55.0,198,45.0
1933,19,33,548,259,47.26,289,52.74
1934,19,34,437,305,69.79,132,30.21
1935,19,35,444,329,74.1,115,25.9
1936,19,36,677,617,91.14,60,8.86
1937,19,37,482,426,88.38,56,11.62
1938,19,38,445,399,89.66,46,10.34
1939,19,39,239,229,95.82,10,4.18
1940,19,40,554,451,81.41,103,18.59
1941,19,41,496,240,48.39,256,51.61
1942,19,42,408,339,83.09,69,16.91
1943,19,43,657,632,96.19,25,3.81
1944,19,44,601,266,44.26,335,55.74
1945,19,45,502,296,58.96,206,41.04
1946,19,46,502,297,59.16,205,40.84
1947,19,47,685,613,89.49,72,10.51
1948,19,48,586,568,96.93,18,3.07
1949,19,49,597,547,91.62,50,8.38
1950,19,50,413,259,62.71,154,37.29
1951,19,51,560,338,60.36,222,39.64
1952,19,52,611,307,50.25,304,49.75
1953,19,53,469,318,67.8,151,32.2
1954,19,54,425,200,47.06,225,52.94
1955,19,55,432,216,50.0,216,50.0
1956,19,56,519,421,81.12,98,18.88
1957,19,57,406,339,83.5,67,16.5
2001,20,1,460,451,98.04,9,1.96
2002,20,2,156,141,90.38,15,9.62
2003,20,3,391,381,97.44,10,2.56
2004,20,4,200,190,95.0,10,5.0
2005,20,5,493,475,96.35,18,3.65
2006,20,6,189,181,95.77,8,4.23
2007,20,7,512,502,98.05,10,1.95
2008,20,8,385,372,96.62,13,3.38
2009,20,9,606,588,97.03,18,2.97
2010,20,10,300,291,97.0,9,3.0
2011,20,11,562,542,96.44,20,3.56
2012,20,12,416,397,95.43,19,4.57
2013,20,13,389,369,94.86,20,5.14
2014,20,14,246,236,95.93,10,4.07
2015,20,15,442,421,95.25,21,4.75
2016,20,16,526,499,94.87,27,5.13
2017,20,17,287,272,94.77,15,5.23
2018,20,18,309,302,97.73,7,2.27
2019,20,19,465,453,97.42,12,2.58
2020,20,20,346,324,93.64,22,6.36
2021,20,21,365,350,95.89,15,4.11
2022,20,22,589,572,97.11,17,2.89
2023,20,23,252,248,98.41,4,1.59
2024,20,24,577,538,93.24,39,6.76
2025,20,25,299,290,96.99,9,3.01
2026,20,26,417,396,94.96,21,5.04
2027,20,27,228,225,98.68,3,1.32
2028,20,28,268,253,94.4,15,5.6
2029,20,29,296,285,96.28,11,3.72
2030,20,30,188,180,95.74,8,4.26
2031,20,31,526,507,96.39,19,3.61
2032,20,32,344,333,96.8,11,3.2
2033,20,33,274,266,97.08,8,2.92
2034,20,34,567,528,93.12,39,6.88
2035,20,35,319,296,92.79,23,7.21
2036,20,36,143,136,95.1,7,4.9
2037,20,37,133,129,96.99,4,3.01
2038,20,38,147,137,93.2,10,6.8
2039,20,39,37,37,100.0,0,0.0
2101,21,1,468,461,98.5,7,1.5
2102,21,2,302,291,96.36,11,3.64
2103,21,3,428,414,96.73,14,3.27
2104,21,4,359,348,96.94,11,3.06
2105,21,5,451,437,96.9,14,3.1
2106,21,6,350,341,97.43,9,2.57
2107,21,7,420,408,97.14,12,2.86
2108,21,8,442,428,96.83,14,3.17
2109,21,9,439,428,97.49,11,2.51
2110,21,10,360,350,97.22,10,2.78
2111,21,11,382,370,96.86,12,3.14
2112,21,12,370,359,97.03,11,2.97
2113,21,13,439,433,98.63,6,1.37
2114,21,14,466,451,96.78,15,3.22
2115,21,15,383,377,98.43,6,1.57
2116,21,16,377,360,95.49,17,4.51
2117,21,17,358,343,95.81,15,4.19
2118,21,18,398,387,97.24,11,2.76
2119,21,19,476,465,97.69,11,2.31
2120,21,20,387,379,97.93,8,2.07
2121,21,21,357,347,97.2,10,2.8
2122,21,22,393,377,95.93,16,4.07
2123,21,23,403,392,97.27,11,2.73
2124,21,24,429,423,98.6,6,1.4
2125,21,25,378,363,96.03,15,3.97
2126,21,26,438,422,96.35,16,3.65
2127,21,27,462,454,98.27,8,1.73
2128,21,28,505,487,96.44,18,3.56
2129,21,29,472,464,98.31,8,1.69
2130,21,30,372,351,94.35,21,5.65
2131,21,31,226,219,96.9,7,3.1
2132,21,32,301,296,98.34,5,1.66
2133,21,33,366,353,96.45,13,3.55
2134,21,34,399,386,96.74,13,3.26
2135,21,35,508,500,98.43,8,1.57
2136,21,36,425,411,96.71,14,3.29
2137,21,37,300,290,96.67,10,3.33
2138,21,38,442,429,97.06,13,2.94
2139,21,39,400,392,98.0,8,2.0
2140,21,40,396,385,97.22,11,2.78
2141,21,41,447,433,96.87,14,3.13
2142,21,42,464,452,97.41,12,2.59
2143,21,43,415,403,97.11,12,2.89
2144,21,44,454,441,97.14,13,2.86
2145,21,45,401,391,97.51,10,2.49
2146,21,46,447,429,95.97,18,4.03
2147,21,47,381,364,95.54,17,4.46
2148,21,48,423,408,96.45,15,3.55
2149,21,49,464,453,97.63,11,2.37
2150,21,50,309,295,95.47,14,4.53
2151,21,51,427,415,97.19,12,2.81
2152,21,52,413,394,95.4,19,4.6
2153,21,53,359,342,95.26,17,4.74
2154,21,54,357,347,97.2,10,2.8
2201,22,1,221,217,98.19,4,1.81
2202,22,2,552,460,83.33,92,16.67
2203,22,3,673,634,94.21,39,5.79
2204,22,4,360,349,96.94,11,3.06
2205,22,5,418,400,95.69,18,4.31
2206,22,6,419,402,95.94,17,4.06
2207,22,7,348,328,94.25,20,5.75
2208,22,8,641,568,88.61,73,11.39
2209,22,9,349,338,96.85,11,3.15
2210,22,10,580,543,93.62,37,6.38
2211,22,11,340,321,94.41,19,5.59
2212,22,12,361,314,86.98,47,13.02
2213,22,13,460,435,94.57,25,5.43
2214,22,14,360,342,95.0,18,5.0
2215,22,15,361,346,95.84,15,4.16
2216,22,16,351,328,93.45,23,6.55
2217,22,17,576,548,95.14,28,4.86
2218,22,18,380,366,96.32,14,3.68
2219,22,19,211,205,97.16,6,2.84
2220,22,20,434,415,95.62,19,4.38
2221,22,21,409,401,98.04,8,1.96
2222,22,22,412,386,93.69,26,6.31
2223,22,23,463,453,97.84,10,2.16
2224,22,24,523,498,95.22,25,4.78
2225,22,25,419,393,93.79,26,6.21
2301,23,1,417,265,63.55,152,36.45
2302,23,2,468,352,75.21,116,24.79
2303,23,3,415,243,58.55,172,41.45
2304,23,4,423,311,73.52,112,26.48
2305,23,5,453,418,92.27,35,7.73
2306,23,6,455,411,90.33,44,9.67
2307,23,7,424,387,91.27,37,8.73
2308,23,8,535,438,81.87,97,18.13
2309,23,9,417,383,91.85,34,8.15
2310,23,10,508,446,87.8,62,12.2
2311,23,11,510,479,93.92,31,6.08
2312,23,12,486,284,58.44,202,41.56
2313,23,13,413,390,94.43,23,5.57
2314,23,14,387,244,63.05,143,36.95
2315,23,15,396,372,93.94,24,6.06
2316,23,16,443,264,59.59,179,40.41
2317,23,17,346,328,94.8,18,5.2
2318,23,18,397,272,68.51,125,31.49
2319,23,19,385,367,95.32,18,4.68
2320,23,20,310,283,91.29,27,8.71
2321,23,21,416,247,59.38,169,40.63
2322,23,22,460,366,79.57,94,20.43
2323,23,23,417,297,71.22,120,28.78
2324,23,24,398,360,90.45,38,9.55
2325,23,25,385,342,88.83,43,11.17
2326,23,26,434,387,89.17,47,10.83
2327,23,27,409,239,58.44,170,41.56
2328,23,28,505,351,69.5,154,30.5
2329,23,29,375,290,77.33,85,22.67
2330,23,30,517,470,90.91,47,9.09
2331,23,31,393,352,89.57,41,10.43
2332,23,32,409,371,90.71,38,9.29
2333,23,33,472,434,91.95,38,8.05
2334,23,34,475,438,92.21,37,7.79
2335,23,35,350,240,68.57,110,31.43
2336,23,36,452,267,59.07,185,40.93
2337,23,37,487,306,62.83,181,37.17
2338,23,38,407,301,73.96,106,26.04
2339,23,39,480,455,94.79,25,5.21
2401,24,1,324,316,97.53,8,2.47
2402,24,2,376,363,96.54,13,3.46
2403,24,3,432,416,96.3,16,3.7
2404,24,4,302,294,97.35,8,2.65
2405,24,5,201,191,95.02,10,4.98
2406,24,6,373,358,95.98,15,4.02
2407,24,7,277,267,96.39,10,3.61
2408,24,8,174,166,95.4,8,4.6
2409,24,9,353,340,96.32,13,3.68
2410,24,10,184,175,95.11,9,4.89
2411,24,11,394,379,96.19,15,3.81
2412,24,12,229,220,96.07,9,3.93
2413,24,13,225,217,96.44,8,3.56
2414,24,14,330,316,95.76,14,4.24
2415,24,15,203,196,96.55,7,3.45
2416,24,16,1057,979,92.62,78,7.38
2417,24,17,275,270,98.18,5,1.82
2418,24,18,321,307,95.64,14,4.36
2419,24,19,407,392,96.31,15,3.69
2420,24,20,308,295,95.78,13,4.22
2421,24,21,203,196,96.55,7,3.45
2422,24,22,445,433,97.3,12,2.7
2423,24,23,318,312,98.11,6,1.89
2424,24,24,427,416,97.42,11,2.58
2425,24,25,291,282,96.91,9,3.09
2426,24,26,534,516,96.63,18,3.37
2427,24,27,376,360,95.74,16,4.26
2428,24,28,227,221,97.36,6,2.64
2429,24,29,276,265,96.01,11,3.99
2430,24,30,227,221,97.36,6,2.64
2431,24,31,397,382,96.22,15,3.78
2432,24,32,189,180,95.24,9,4.76
2433,24,33,221,214,96.83,7,3.17
2434,24,34,346,337,97.4,9,2.6
2435,24,35,349,339,97.13,10,2.87
2436,24,36,415,397,95.66,18,4.34
2437,24,37,184,179,97.28,5,2.72
2438,24,38,293,282,96.25,11,3.75
2439,24,39,360,346,96.11,14,3.89
2440,24,40,429,409,95.34,20,4.66
2441,24,41,167,160,95.81,7,4.19
2501,25,1,439,408,92.94,31,7.06
2502,25,2,695,655,94.24,40,5.76
2503,25,3,1032,861,83.43,171,16.57
2504,25,4,437,395,90.39,42,9.61
2505,25,5,560,502,89.64,58,10.36
2506,25,6,208,188,90.38,20,9.62
2507,25,7,599,562,93.82,37,6.18
2508,25,8,632,605,95.73,27,4.27
2509,25,9,554,525,94.77,29,5.23
2510,25,10,842,693,82.3,149,17.7
2511,25,11,590,551,93.39,39,6.61
2512,25,12,537,490,91.25,47,8.75
2513,25,13,673,639,94.95,34,5.05
2514,25,14,438,394,89.95,44,10.05
2515,25,15,483,440,91.1,43,8.9
2516,25,16,1058,849,80.25,209,19.75
2517,25,17,591,543,91.88,48,8.12
2518,25,18,354,299,84.46,55,15.54
2519,25,19,599,569,94.99,30,5.01
2520,25,20,326,293,89.88,33,10.12
2521,25,21,1125,976,86.76,149,13.24
2522,25,22,577,548,94.97,29,5.03
2523,25,23,642,599,93.3,43,6.7
2524,25,24,584,543,92.98,41,7.02
2525,25,25,516,412,79.84,104,20.16
2526,25,26,562,520,92.53,42,7.47
2527,25,27,790,674,85.32,116,14.68
2528,25,28,607,569,93.74,38,6.26
2529,25,29,451,414,91.8,37,8.2
2530,25,30,553,515,93.13,38,6.87
2531,25,31,1211,988,81.59,223,18.41
2532,25,32,484,428,88.43,56,11.57
2601,26,1,476,428,89.92,48,10.08
2602,26,2,377,350,92.84,27,7.16
2603,26,3,541,481,88.91,60,11.09
2604,26,4,316,297,93.99,19,6.01
2605,26,5,396,373,94.19,23,5.81
2606,26,6,379,355,93.67,24,6.33
2607,26,7,418,391,93.54,27,6.46
2608,26,8,278,258,92.81,20,7.19
2609,26,9,357,340,95.24,17,4.76
2610,26,10,435,402,92.41,33,7.59
2611,26,11,426,384,90.14,42,9.86
2612,26,12,456,425,93.2,31,6.8
2613,26,13,249,237,95.18,12,4.82
2614,26,14,357,341,95.52,16,4.48
2615,26,15,275,250,90.91,25,9.09
2616,26,16,244,228,93.44,16,6.56
2617,26,17,397,326,82.12,71,17.88
2618,26,18,315,285,90.48,30,9.52
2619,26,19,269,252,93.68,17,6.32
2620,26,20,402,372,92.54,30,7.46
2621,26,21,508,479,94.29,29,5.71
2622,26,22,262,246,93.89,16,6.11
2623,26,23,324,310,95.68,14,4.32
2624,26,24,366,348,95.08,18,4.92
2625,26,25,354,334,94.35,20,5.65
2626,26,26,314,293,93.31,21,6.69
2627,26,27,492,450,91.46,42,8.54
2628,26,28,577,496,85.96,81,14.04
2629,26,29,242,213,88.02,29,11.98
2630,26,30,354,332,93.79,22,6.21
2631,26,31,208,184,88.46,24,11.54
2632,26,32,543,477,87.85,66,12.15
2633,26,33,507,482,95.07,25,4.93
2634,26,34,468,434,92.74,34,7.26
2635,26,35,378,354,93.65,24,6.35
2636,26,36,452,399,88.27,53,11.73
2637,26,37,460,440,95.65,20,4.35
2638,26,38,211,194,91.94,17,8.06
2639,26,39,522,476,91.19,46,8.81
2640,26,40,286,269,94.06,17,5.94
2641,26,41,477,452,94.76,25,5.24
2642,26,42,355,329,92.68,26,7.32
2643,26,43,272,259,95.22,13,4.78
2644,26,44,243,228,93.83,15,6.17
2645,26,45,229,207,90.39,22,9.61
2646,26,46,347,293,84.44,54,15.56
2647,26,47,318,299,94.03,19,5.97
2648,26,48,451,421,93.35,30,6.65
2649,26,49,290,278,95.86,12,4.14
2701,27,1,1276,1077,84.4,199,15.6
2702,27,2,582,483,82.99,99,17.01
2703,27,3,240,233,97.08,7,2.92
2704,27,4,259,248,95.75,11,4.25
2705,27,5,392,376,95.92,16,4.08
2706,27,6,633,552,87.2,81,12.8
2707,27,7,741,668,90.15,73,9.85
2708,27,8,383,368,96.08,15,3.92
2709,27,9,283,223,78.8,60,21.2
2710,27,10,423,393,92.91,30,7.09
2711,27,11,669,560,83.71,109,16.29
2712,27,12,452,386,85.4,66,14.6
2713,27,13,668,611,91.47,57,8.53
2714,27,14,233,221,94.85,12,5.15
2715,27,15,246,230,93.5,16,6.5
2716,27,16,651,537,82.49,114,17.51
2717,27,17,505,474,93.86,31,6.14
2718,27,18,330,303,91.82,27,8.18
2719,27,19,240,224,93.33,16,6.67
2720,27,20,331,314,94.86,17,5.14
2721,27,21,521,439,84.26,82,15.74
2722,27,22,212,202,95.28,10,4.72
2723,27,23,289,280,96.89,9,3.11
2724,27,24,313,294,93.93,19,6.07
2725,27,25,457,427,93.44,30,6.56
2726,27,26,324,303,93.52,21,6.48
2727,27,27,649,606,93.37,43,6.63
2728,27,28,745,641,86.04,104,13.96
2729,27,29,307,295,96.09,12,3.91
2730,27,30,215,207,96.28,8,3.72
2731,27,31,344,332,96.51,12,3.49
2732,27,32,450,419,93.11,31,6.89
2733,27,33,738,647,87.67,91,12.33
2734,27,34,251,246,98.01,5,1.99
2735,27,35,687,572,83.26,115,16.74
2736,27,36,339,324,95.58,15,4.42
2737,27,37,547,484,88.48,63,11.52
2738,27,38,677,604,89.22,73,10.78
2739,27,39,334,309,92.51,25,7.49
2740,27,40,757,637,84.15,120,15.85
2741,27,41,369,353,95.66,16,4.34
2742,27,42,373,330,88.47,43,11.53
2743,27,43,379,370,97.63,9,2.37
2744,27,44,324,314,96.91,10,3.09
2745,27,45,1616,1363,84.34,253,15.66
2746,27,46,493,386,78.3,107,21.7
2747,27,47,304,288,94.74,16,5.26
2748,27,48,980,860,87.76,120,12.24
2749,27,49,334,326,97.6,8,2.4
2750,27,50,427,410,96.02,17,3.98
2801,28,1,264,252,95.45,12,4.55
2802,28,2,350,337,96.29,13,3.71
2803,28,3,279,265,94.98,14,5.02
2804,28,4,427,367,85.95,60,14.05
2805,28,5,245,232,94.69,13,5.31
2806,28,6,226,192,84.96,34,15.04
2807,28,7,381,360,94.49,21,5.51
2808,28,8,641,549,85.65,92,14.35
2809,28,9,355,343,96.62,12,3.38
2810,28,10,548,481,87.77,67,12.23
2811,28,11,915,845,92.35,70,7.65
2812,28,12,331,319,96.37,12,3.63
2813,28,13,403,377,93.55,26,6.45
2814,28,14,348,331,95.11,17,4.89
2815,28,15,65,62,95.38,3,4.62
2816,28,16,234,226,96.58,8,3.42
2817,28,17,309,303,98.06,6,1.94
2818,28,18,298,287,96.31,11,3.69
2819,28,19,339,301,88.79,38,11.21
2820,28,20,294,280,95.24,14,4.76
2821,28,21,302,289,95.7,13,4.3
2822,28,22,341,326,95.6,15,4.4
2823,28,23,443,422,95.26,21,4.74
2824,28,24,308,289,93.83,19,6.17
2825,28,25,525,509,96.95,16,3.05
2826,28,26,356,347,97.47,9,2.53
2827,28,27,441,358,81.18,83,18.82
2828,28,28,543,446,82.14,97,17.86
2829,28,29,192,178,92.71,14,7.29
2830,28,30,50,50,100.0,0,0.0
2831,28,31,408,392,96.08,16,3.92
2832,28,32,355,335,94.37,20,5.63
2833,28,33,384,368,95.83,16,4.17
2834,28,34,649,619,95.38,30,4.62
2835,28,35,441,421,95.46,20,4.54
2836,28,36,187,182,97.33,5,2.67
2837,28,37,411,394,95.86,17,4.14
2838,28,38,144,138,95.83,6,4.17
2839,28,39,283,269,95.05,14,4.95
2840,28,40,468,457,97.65,11,2.35
2841,28,41,234,221,94.44,13,5.56
2842,28,42,364,344,94.51,20,5.49
2843,28,43,428,415,96.96,13,3.04
2844,28,44,260,249,95.77,11,4.23
2845,28,45,615,528,85.85,87,14.15
2846,28,46,754,660,87.53,94,12.47
2901,29,1,628,563,89.65,65,10.35
2902,29,2,531,518,97.55,13,2.45
2903,29,3,418,400,95.69,18,4.31
2904,29,4,526,516,98.1,10,1.9
2905,29,5,342,326,95.32,16,4.68
2906,29,6,340,326,95.88,14,4.12
2907,29,7,482,448,92.95,34,7.05
2908,29,8,430,408,94.88,22,5.12
2909,29,9,522,433,82.95,89,17.05
2910,29,10,614,544,88.6,70,11.4
2911,29,11,250,241,96.4,9,3.6
2912,29,12,559,534,95.53,25,4.47
2913,29,13,442,428,96.83,14,3.17
2914,29,14,396,387,97.73,9,2.27
2915,29,15,497,485,97.59,12,2.41
2916,29,16,409,397,97.07,12,2.93
2917,29,17,412,396,96.12,16,3.88
2918,29,18,419,399,95.23,20,4.77
2919,29,19,418,402,96.17,16,3.83
2920,29,20,460,436,94.78,24,5.22
2921,29,21,567,536,94.53,31,5.47
2922,29,22,386,361,93.52,25,6.48
2923,29,23,568,476,83.8,92,16.2
2924,29,24,427,416,97.42,11,2.58
2925,29,25,489,475,97.14,14,2.86
2926,29,26,422,401,95.02,21,4.98
2927,29,27,411,398,96.84,13,3.16
2928,29,28,547,520,95.06,27,4.94
2929,29,29,616,495,80.36,121,19.64
2930,29,30,655,597,91.15,58,8.85
2931,29,31,552,413,74.82,139,25.18
2932,29,32,564,442,78.37,122,21.63
2933,29,33,319,301,94.36,18,5.64
2934,29,34,329,304,92.4,25,7.6
2935,29,35,317,305,96.21,12,3.79
2936,29,36,382,373,97.64,9,2.36
2937,29,37,430,408,94.88,22,5.12
2938,29,38,607,540,88.96,67,11.04
2939,29,39,560,493,88.04,67,11.96
2940,29,40,497,487,97.99,10,2.01
2941,29,41,389,377,96.92,12,3.08
2942,29,42,496,473,95.36,23,4.64
2943,29,43,589,557,94.57,32,5.43
2944,29,44,500,476,95.2,24,4.8
3001,30,1,600,532,88.67,68,11.33
3002,30,2,569,490,86.12,79,13.88
3003,30,3,422,378,89.57,44,10.43
3004,30,4,533,441,82.74,92,17.26
3005,30,5,417,382,91.61,35,8.39
3006,30,6,359,323,89.97,36,10.03
3007,30,7,587,522,88.93,65,11.07
3008,30,8,650,584,89.85,66,10.15
3009,30,9,483,431,89.23,52,10.77
3010,30,10,518,465,89.77,53,10.23
3011,30,11,525,495,94.29,30,5.71
3012,30,12,512,457,89.26,55,10.74
3013,30,13,538,478,88.85,60,11.15
3014,30,14,406,374,92.12,32,7.88
3015,30,15,480,407,84.79,73,15.21
3016,30,16,314,277,88.22,37,11.78
3017,30,17,556,499,89.75,57,10.25
3018,30,18,665,624,93.83,41,6.17
3019,30,19,552,518,93.84,34,6.16
3020,30,20,602,527,87.54,75,12.46
3021,30,21,409,340,83.13,69,16.87
3022,30,22,775,719,92.77,56,7.23
3023,30,23,672,619,92.11,53,7.89
3024,30,24,795,737,92.7,58,7.3
3025,30,25,792,733,92.55,59,7.45
3026,30,26,343,312,90.96,31,9.04
3027,30,27,400,351,87.75,49,12.25
3028,30,28,553,507,91.68,46,8.32
3029,30,29,382,355,92.93,27,7.07
3030,30,30,229,218,95.2,11,4.8
3031,30,31,351,308,87.75,43,12.25
3032,30,32,456,411,90.13,45,9.87
3101,31,1,350,319,91.14,31,8.86
3102,31,2,315,302,95.87,13,4.13
3103,31,3,368,331,89.95,37,10.05
3104,31,4,463,437,94.38,26,5.62
3105,31,5,375,347,92.53,28,7.47
3106,31,6,259,243,93.82,16,6.18
3107,31,7,541,501,92.61,40,7.39
3108,31,8,322,302,93.79,20,6.21
3109,31,9,391,355,90.79,36,9.21
3110,31,10,431,403,93.5,28,6.5
3111,31,11,316,276,87.34,40,12.66
3112,31,12,319,275,86.21,44,13.79
3113,31,13,398,380,95.48,18,4.52
3114,31,14,357,314,87.96,43,12.04
3115,31,15,374,338,90.37,36,9.63
3116,31,16,438,412,94.06,26,5.94
3117,31,17,340,308,90.59,32,9.41
3118,31,18,337,310,91.99,27,8.01
3119,31,19,344,308,89.53,36,10.47
3120,31,20,314,291,92.68,23,7.32
3121,31,21,323,302,93.5,21,6.5
3122,31,22,305,287,94.1,18,5.9
3123,31,23,392,341,86.99,51,13.01
3124,31,24,372,345,92.74,27,7.26
3125,31,25,351,319,90.88,32,9.12
3126,31,26,375,340,90.67,35,9.33
3127,31,27,413,361,87.41,52,12.59
3128,31,28,327,298,91.13,29,8.87
3129,31,29,347,320,92.22,27,7.78
3130,31,30,297,276,92.93,21,7.07
3131,31,31,315,277,87.94,38,12.06
3132,31,32,290,266,91.72,24,8.28
3133,31,33,356,320,89.89,36,10.11
3134,31,34,374,332,88.77,42,11.23
3135,31,35,437,401,91.76,36,8.24
3136,31,36,384,354,92.19,30,7.81
3137,31,37,337,308,91.39,29,8.61
3138,31,38,329,302,91.79,27,8.21
3139,31,39,418,397,94.98,21,5.02
3140,31,40,410,375,91.46,35,8.54
3141,31,41,341,324,95.01,17,4.99
3201,32,1,847,730,86.19,117,13.81
3202,32,2,767,653,85.14,114,14.86
3203,32,3,707,656,92.79,51,7.21
3204,32,4,649,562,86.59,87,13.41
3205,32,5,724,640,88.4,84,11.6
3206,32,6,826,722,87.41,104,12.59
3207,32,7,805,707,87.83,98,12.17
3208,32,8,896,737,82.25,159,17.75
3209,32,9,733,617,84.17,116,15.83
3210,32,10,807,659,81.66,148,18.34
3211,32,11,588,529,89.97,59,10.03
3212,32,12,466,435,93.35,31,6.65
3213,32,13,807,683,84.63,124,15.37
3214,32,14,712,651,91.43,61,8.57
3215,32,15,659,559,84.83,100,15.17
3216,32,16,675,579,85.78,96,14.22
3217,32,17,648,587,90.59,61,9.41
3218,32,18,681,551,80.91,130,19.09
3219,32,19,675,591,87.56,84,12.44
3220,32,20,619,577,93.21,42,6.79
3221,32,21,710,601,84.65,109,15.35
3222,32,22,782,717,91.69,65,8.31
3223,32,23,732,609,83.2,123,16.8
3224,32,24,627,500,79.74,127,20.26
3225,32,25,687,596,86.75,91,13.25
3226,32,26,681,625,91.78,56,8.22
3227,32,27,758,610,80.47,148,19.53
3228,32,28,652,588,90.18,64,9.82
3229,32,29,707,618,87.41,89,12.59
3230,32,30,722,569,78.81,153,21.19
3231,32,31,771,638,82.75,133,17.25
3232,32,32,797,671,84.19,126,15.81
3233,32,33,673,551,81.87,122,18.13
3234,32,34,777,686,88.29,91,11.71
3235,32,35,697,575,82.5,122,17.5
3236,32,36,747,634,84.87,113,15.13
3237,32,37,804,705,87.69,99,12.31
3238,32,38,726,623,85.81,103,14.19
3239,32,39,829,655,79.01,174,20.99
3240,32,40,711,593,83.4,118,16.6
3241,32,41,759,592,78.0,167,22.0
3242,32,42,676,559,82.69,117,17.31
3243,32,43,596,547,91.78,49,8.22
3301,33,1,698,659,94.41,39,5.59
3302,33,2,872,801,91.86,71,8.14
3303,33,3,930,843,90.65,87,9.35
3304,33,4,919,816,88.79,103,11.21
3305,33,5,693,620,89.47,73,10.53
3306,33,6,607,554,91.27,53,8.73
3307,33,7,708,668,94.35,40,5.65
3308,33,8,844,752,89.1,92,10.9
3309,33,9,770,664,86.23,106,13.77
3310,33,10,595,536,90.08,59,9.92
3311,33,11,693,634,91.49,59,8.51
3312,33,12,704,638,90.63,66,9.38
3313,33,13,658,597,90.73,61,9.27
3314,33,14,326,287,88.04,39,11.96
3315,33,15,704,643,91.34,61,8.66
3316,33,16,936,837,89.42,99,10.58
3317,33,17,714,638,89.36,76,10.64
3318,33,18,998,920,92.18,78,7.82
3319,33,19,838,744,88.78,94,11.22
3320,33,20,854,799,93.56,55,6.44
3321,33,21,707,649,91.8,58,8.2
3322,33,22,644,562,87.27,82,12.73
3323,33,23,758,687,90.63,71,9.37
3324,33,24,819,712,86.94,107,13.06
3325,33,25,830,738,88.92,92,11.08
3326,33,26,522,489,93.68,33,6.32
3327,33,27,810,748,92.35,62,7.65
3328,33,28,625,585,93.6,40,6.4
3401,34,1,462,452,97.84,10,2.16
3402,34,2,381,368,96.59,13,3.41
3403,34,3,428,420,98.13,8,1.87
3404,34,4,329,321,97.57,8,2.43
3405,34,5,388,375,96.65,13,3.35
3406,34,6,492,476,96.75,16,3.25
3407,34,7,455,442,97.14,13,2.86
3408,34,8,359,349,97.21,10,2.79
3409,34,9,296,285,96.28,11,3.72
3410,34,10,340,335,98.53,5,1.47
3411,34,11,377,361,95.76,16,4.24
3412,34,12,468,458,97.86,10,2.14
3413,34,13,434,422,97.24,12,2.76
3414,34,14,349,337,96.56,12,3.44
3415,34,15,407,392,96.31,15,3.69
3416,34,16,384,367,95.57,17,4.43
3417,34,17,520,505,97.12,15,2.88
3418,34,18,303,293,96.7,10,3.3
3419,34,19,470,455,96.81,15,3.19
3420,34,20,466,453,97.21,13,2.79
3421,34,21,491,475,96.74,16,3.26
3422,34,22,429,423,98.6,6,1.4
3423,34,23,359,354,98.61,5,1.39
3424,34,24,367,357,97.28,10,2.72
3425,34,25,633,618,97.63,15,2.37
3426,34,26,487,470,96.51,17,3.49
3427,34,27,357,347,97.2,10,2.8
3428,34,28,274,263,95.99,11,4.01
3429,34,29,357,345,96.64,12,3.36
3430,34,30,414,398,96.14,16,3.86
3431,34,31,357,341,95.52,16,4.48
3432,34,32,418,405,96.89,13,3.11
3433,34,33,364,346,95.05,18,4.95
3434,34,34,490,475,96.94,15,3.06
3435,34,35,524,507,96.76,17,3.24
3436,34,36,365,350,95.89,15,4.11
3437,34,37,249,242,97.19,7,2.81
3438,34,38,213,206,96.71,7,3.29
3439,34,39,326,310,95.09,16,4.91
3440,34,40,465,455,97.85,10,2.15
3441,34,41,257,249,96.89,8,3.11
3442,34,42,407,400,98.28,7,1.72
3443,34,43,386,375,97.15,11,2.85
3444,34,44,398,389,97.74,9,2.26
3445,34,45,430,417,96.98,13,3.02
3446,34,46,288,280,97.22,8,2.78
3447,34,47,388,378,97.42,10,2.58
3448,34,48,417,408,97.84,9,2.16
3449,34,49,391,385,98.47,6,1.53
3450,34,50,346,340,98.27,6,1.73
3451,34,51,463,444,95.9,19,4.1
3452,34,52,325,321,98.77,4,1.23
3453,34,53,299,283,94.65,16,5.35
3501,35,1,618,566,91.59,52,8.41
3502,35,2,601,543,90.35,58,9.65
3503,35,3,524,487,92.94,37,7.06
3504,35,4,596,530,88.93,66,11.07
3505,35,5,513,480,93.57,33,6.43
3506,35,6,598,554,92.64,44,7.36
3507,35,7,611,569,93.13,42,6.87
3508,35,8,593,548,92.41,45,7.59
3509,35,9,537,493,91.81,44,8.19
3510,35,10,691,647,93.63,44,6.37
3511,35,11,675,618,91.56,57,8.44
3512,35,12,420,390,92.86,30,7.14
3513,35,13,422,398,94.31,24,5.69
3514,35,14,477,449,94.13,28,5.87
3515,35,15,693,644,92.93,49,7.07
3516,35,16,334,314,94.01,20,5.99
3517,35,17,595,559,93.95,36,6.05
3518,35,18,386,364,94.3,22,5.7
3519,35,19,375,357,95.2,18,4.8
3520,35,20,595,549,92.27,46,7.73
3521,35,21,593,558,94.1,35,5.9
3522,35,22,704,656,93.18,48,6.82
3523,35,23,615,549,89.27,66,10.73
3524,35,24,534,480,89.89,54,10.11
3525,35,25,609,562,92.28,47,7.72
3526,35,26,503,451,89.66,52,10.34
3527,35,27,538,484,89.96,54,10.04
3528,35,28,557,505,90.66,52,9.34
3529,35,29,561,517,92.16,44,7.84
3530,35,30,559,524,93.74,35,6.26
3531,35,31,628,542,86.31,86,13.69
3601,36,1,489,439,89.78,50,10.22
3602,36,2,496,465,93.75,31,6.25
3603,36,3,443,401,90.52,42,9.48
3604,36,4,534,492,92.13,42,7.87
3605,36,5,431,410,95.13,21,4.87
3606,36,6,460,421,91.52,39,8.48
3607,36,7,560,430,76.79,130,23.21
3608,36,8,407,381,93.61,26,6.39
3609,36,9,472,436,92.37,36,7.63
3610,36,10,636,577,90.72,59,9.28
3611,36,11,352,325,92.33,27,7.67
3612,36,12,335,313,93.43,22,6.57
3613,36,13,356,338,94.94,18,5.06
3614,36,14,546,467,85.53,79,14.47
3615,36,15,524,440,83.97,84,16.03
3616,36,16,510,443,86.86,67,13.14
3617,36,17,606,503,83.0,103,17.0
3618,36,18,539,446,82.75,93,17.25
3619,36,19,630,564,89.52,66,10.48
3620,36,20,567,479,84.48,88,15.52
3621,36,21,465,438,94.19,27,5.81
3622,36,22,444,404,90.99,40,9.01
3623,36,23,442,413,93.44,29,6.56
3624,36,24,593,514,86.68,79,13.32
3625,36,25,506,470,92.89,36,7.11
3626,36,26,496,391,78.83,105,21.17
3627,36,27,465,411,88.39,54,11.61
3628,36,28,521,428,82.15,93,17.85
3629,36,29,550,445,80.91,105,19.09
3630,36,30,489,410,83.84,79,16.16
3701,37,1,221,209,94.57,12,5.43
3702,37,2,355,341,96.06,14,3.94
3703,37,3,281,272,96.8,9,3.2
3704,37,4,328,310,94.51,18,5.49
3705,37,5,408,393,96.32,15,3.68
3706,37,6,265,260,98.11,5,1.89
3707,37,7,338,320,94.67,18,5.33
3708,37,8,306,290,94.77,16,5.23
3709,37,9,400,384,96.0,16,4.0
3710,37,10,497,464,93.36,33,6.64
3711,37,11,260,251,96.54,9,3.46
3712,37,12,371,352,94.88,19,5.12
3713,37,13,300,286,95.33,14,4.67
3714,37,14,441,421,95.46,20,4.54
3715,37,15,406,387,95.32,19,4.68
3716,37,16,445,432,97.08,13,2.92
3717,37,17,289,279,96.54,10,3.46
3718,37,18,345,330,95.65,15,4.35
3719,37,19,285,276,96.84,9,3.16
3720,37,20,353,342,96.88,11,3.12
3721,37,21,366,349,95.36,17,4.64
3722,37,22,372,353,94.89,19,5.11
3723,37,23,383,372,97.13,11,2.87
3724,37,24,372,357,95.97,15,4.03
3725,37,25,345,326,94.49,19,5.51
3726,37,26,519,492,94.8,27,5.2
3727,37,27,371,356,95.96,15,4.04
3728,37,28,356,343,96.35,13,3.65
3729,37,29,370,348,94.05,22,5.95
3730,37,30,346,338,97.69,8,2.31
3731,37,31,445,428,96.18,17,3.82
3732,37,32,354,335,94.63,19,5.37
3733,37,33,294,278,94.56,16,5.44
3734,37,34,347,338,97.41,9,2.59
3735,37,35,395,382,96.71,13,3.29
3736,37,36,281,272,96.8,9,3.2
3737,37,37,422,405,95.97,17,4.03
3738,37,38,418,397,94.98,21,5.02
3739,37,39,321,310,96.57,11,3.43
3740,37,40,408,395,96.81,13,3.19
3741,37,41,405,386,95.31,19,4.69
3801,38,1,502,435,86.65,67,13.35
3802,38,2,542,296,54.61,246,45.39
3803,38,3,550,416,75.64,134,24.36
3804,38,4,531,387,72.88,144,27.12
3805,38,5,543,413,76.06,130,23.94
3806,38,6,564,426,75.53,138,24.47
3807,38,7,515,353,68.54,162,31.46
3808,38,8,518,398,76.83,120,23.17
3809,38,9,613,442,72.1,171,27.9
3810,38,10,487,385,79.06,102,20.94
3811,38,11,477,387,81.13,90,18.87
3812,38,12,516,299,57.95,217,42.05
3813,38,13,611,425,69.56,186,30.44
3814,38,14,563,437,77.62,126,22.38
3815,38,15,501,407,81.24,94,18.76
3816,38,16,527,385,73.06,142,26.94
3817,38,17,647,435,67.23,212,32.77
3818,38,18,574,423,73.69,151,26.31
3819,38,19,597,459,76.88,138,23.12
3820,38,20,554,373,67.33,181,32.67
3821,38,21,506,430,84.98,76,15.02
3822,38,22,486,406,83.54,80,16.46
3823,38,23,553,428,77.4,125,22.6
3824,38,24,572,387,67.66,185,32.34
3825,38,25,506,388,76.68,118,23.32
3826,38,26,555,437,78.74,118,21.26
3827,38,27,546,375,68.68,171,31.32
3828,38,28,659,420,63.73,239,36.27
3829,38,29,559,448,80.14,111,19.86
3830,38,30,540,391,72.41,149,27.59
3831,38,31,530,413,77.92,117,22.08
3832,38,32,526,410,77.95,116,22.05
3833,38,33,479,396,82.67,83,17.33
3834,38,34,505,439,86.93,66,13.07
3835,38,35,524,442,84.35,82,15.65
3836,38,36,515,411,79.81,104,20.19
3837,38,37,530,432,81.51,98,18.49
3838,38,38,527,392,74.38,135,25.62
3839,38,39,580,481,82.93,99,17.07
3840,38,40,534,413,77.34,121,22.66
3841,38,41,494,419,84.82,75,15.18
3901,39,1,557,377,67.68,180,32.32
3902,39,2,389,330,84.83,59,15.17
3903,39,3,588,497,84.52,91,15.48
3904,39,4,526,373,70.91,153,29.09
3905,39,5,564,481,85.28,83,14.72
3906,39,6,554,485,87.55,69,12.45
3907,39,7,479,412,86.01,67,13.99
3908,39,8,546,479,87.73,67,12.27
3909,39,9,505,419,82.97,86,17.03
3910,39,10,246,227,92.28,19,7.72
3911,39,11,523,438,83.75,85,16.25
3912,39,12,721,650,90.15,71,9.85
3913,39,13,483,408,84.47,75,15.53
3914,39,14,543,455,83.79,88,16.21
3915,39,15,639,442,69.17,197,30.83
3916,39,16,515,469,91.07,46,8.93
3917,39,17,565,454,80.35,111,19.65
3918,39,18,534,447,83.71,87,16.29
3919,39,19,532,436,81.95,96,18.05
3920,39,20,685,482,70.36,203,29.64
3921,39,21,550,387,70.36,163,29.64
3922,39,22,532,472,88.72,60,11.28
3923,39,23,549,361,65.76,188,34.24
3924,39,24,677,454,67.06,223,32.94
3925,39,25,471,422,89.6,49,10.4
3926,39,26,532,388,72.93,144,27.07
3927,39,27,80,56,70.0,24,30.0
3928,39,28,672,593,88.24,79,11.76
3929,39,29,287,258,89.9,29,10.1
3930,39,30,657,598,91.02,59,8.98
3931,39,31,486,428,88.07,58,11.93
3932,39,32,471,379,80.47,92,19.53
3933,39,33,562,495,88.08,67,11.92
3934,39,34,652,561,86.04,91,13.96
3935,39,35,547,485,88.67,62,11.33
3936,39,36,137,123,89.78,14,10.22
3937,39,37,513,380,74.07,133,25.93
3938,39,38,286,230,80.42,56,19.58
3939,39,39,349,266,76.22,83,23.78
3940,39,40,561,405,72.19,156,27.81
3941,39,41,563,404,71.76,159,28.24
3942,39,42,570,362,63.51,208,36.49
3943,39,43,550,361,65.64,189,34.36
3944,39,44,444,288,64.86,156,35.14
3945,39,45,495,337,68.08,158,31.92
4001,40,1,561,472,84.14,89,15.86
4002,40,2,618,547,88.51,71,11.49
4003,40,3,757,683,90.22,74,9.78
4004,40,4,375,333,88.8,42,11.2
4005,40,5,648,577,89.04,71,10.96
4006,40,6,714,654,91.6,60,8.4
4007,40,7,582,505,86.77,77,13.23
4008,40,8,805,739,91.8,66,8.2
4009,40,9,478,443,92.68,35,7.32
4010,40,10,665,609,91.58,56,8.42
4011,40,11,624,554,88.78,70,11.22
4012,40,12,549,490,89.25,59,10.75
4013,40,13,882,814,92.29,68,7.71
4014,40,14,574,508,88.5,66,11.5
4015,40,15,612,544,88.89,68,11.11
4016,40,16,806,722,89.58,84,10.42
4017,40,17,493,433,87.83,60,12.17
4018,40,18,484,445,91.94,39,8.06
4019,40,19,746,658,88.2,88,11.8
4020,40,20,638,587,92.01,51,7.99
4021,40,21,680,614,90.29,66,9.71
4022,40,22,725,663,91.45,62,8.55
4023,40,23,722,659,91.27,63,8.73
4024,40,24,562,507,90.21,55,9.79
4025,40,25,709,648,91.4,61,8.6
4026,40,26,649,596,91.83,53,8.17
4027,40,27,766,697,90.99,69,9.01
4028,40,28,629,572,90.94,57,9.06
4029,40,29,611,517,84.62,94,15.38
4030,40,30,520,421,80.96,99,19.04
4031,40,31,669,616,92.08,53,7.92
4032,40,32,668,597,89.37,71,10.63
4033,40,33,585,545,93.16,40,6.84
4034,40,34,549,455,82.88,94,17.12
4035,40,35,431,390,90.49,41,9.51
4036,40,36,514,461,89.69,53,10.31
4037,40,37,627,575,91.71,52,8.29
4038,40,38,738,663,89.84,75,10.16
4039,40,39,242,223,92.15,19,7.85
4101,41,1,555,289,52.07,266,47.93
4102,41,2,612,309,50.49,303,49.51
4103,41,3,564,363,64.36,201,35.64
4104,41,4,557,323,57.99,234,42.01
4105,41,5,691,470,68.02,221,31.98
4106,41,6,641,375,58.5,266,41.5
4107,41,7,601,341,56.74,260,43.26
4108,41,8,595,355,59.66,240,40.34
4109,41,9,552,370,67.03,182,32.97
4110,41,10,583,333,57.12,250,42.88
4111,41,11,629,357,56.76,272,43.24
4112,41,12,610,419,68.69,191,31.31
4113,41,13,687,415,60.41,272,39.59
4114,41,14,628,416,66.24,212,33.76
4115,41,15,716,449,62.71,267,37.29
4116,41,16,555,341,61.44,214,38.56
4117,41,17,523,334,63.86,189,36.14
4118,41,18,538,334,62.08,204,37.92
4119,41,19,609,407,66.83,202,33.17
4120,41,20,420,278,66.19,142,33.81
4121,41,21,568,354,62.32,214,37.68
4122,41,22,649,404,62.25,245,37.75
4123,41,23,614,346,56.35,268,43.65
4124,41,24,563,350,62.17,213,37.83
4125,41,25,545,430,78.9,115,21.1
4126,41,26,505,295,58.42,210,41.58
4127,41,27,541,379,70.06,162,29.94
4128,41,28,606,476,78.55,130,21.45
4129,41,29,488,370,75.82,118,24.18
4130,41,30,502,343,68.33,159,31.67
4131,41,31,520,374,71.92,146,28.08
4132,41,32,496,310,62.5,186,37.5
4133,41,33,547,331,60.51,216,39.49
4134,41,34,530,304,57.36,226,42.64
4135,41,35,715,431,60.28,284,39.72
4136,41,36,593,388,65.43,205,34.57
4137,41,37,642,401,62.46,241,37.54
4138,41,38,573,384,67.02,189,32.98
4139,41,39,613,375,61.17,238,38.83
4140,41,40,645,350,54.26,295,45.74
4141,41,41,625,383,61.28,242,38.72
4142,41,42,596,343,57.55,253,42.45
4143,41,43,599,392,65.44,207,34.56
4144,41,44,591,323,54.65,268,45.35
4145,41,45,569,359,63.09,210,36.91
4146,41,46,583,354,60.72,229,39.28
4147,41,47,641,403,62.87,238,37.13
4201,42,1,577,436,75.56,141,24.44
4202,42,2,882,747,84.69,135,15.31
4203,42,3,727,615,84.59,112,15.41
4204,42,4,1722,1387,80.55,335,19.45
4205,42,5,614,481,78.34,133,21.66
4206,42,6,624,506,81.09,118,18.91
4207,42,7,818,638,78.0,180,22.0
4208,42,8,557,468,84.02,89,15.98
4209,42,9,906,766,84.55,140,15.45
4210,42,10,970,761,78.45,209,21.55
4211,42,11,459,349,76.03,110,23.97
4212,42,12,574,435,75.78,139,24.22
4213,42,13,518,397,76.64,121,23.36
4214,42,14,993,799,80.46,194,19.54
4215,42,15,1011,814,80.51,197,19.49
4216,42,16,704,570,80.97,134,19.03
4217,42,17,1159,861,74.29,298,25.71
4218,42,18,923,795,86.13,128,13.87
4219,42,19,887,702,79.14,185,20.86
4220,42,20,913,687,75.25,226,24.75
4221,42,21,883,767,86.86,116,13.14
4222,42,22,398,324,81.41,74,18.59
4223,42,23,785,598,76.18,187,23.82
4224,42,24,651,505,77.57,146,22.43
4225,42,25,833,639,76.71,194,23.29
4226,42,26,1211,918,75.81,293,24.19
4227,42,27,482,379,78.63,103,21.37
4228,42,28,694,556,80.12,138,19.88
4229,42,29,845,656,77.63,189,22.37
4230,42,30,514,386,75.1,128,24.9
4231,42,31,848,676,79.72,172,20.28
4232,42,32,862,668,77.49,194,22.51
4233,42,33,777,629,80.95,148,19.05
4234,42,34,572,417,72.9,155,27.1
4235,42,35,881,733,83.2,148,16.8
4236,42,36,1267,1050,82.87,217,17.13
4237,42,37,552,437,79.17,115,20.83
4238,42,38,725,565,77.93,160,22.07
4239,42,39,1317,1075,81.62,242,18.38
4240,42,40,1068,886,82.96,182,17.04
4241,42,41,726,611,84.16,115,15.84
4242,42,42,1248,1026,82.21,222,17.79
4301,43,1,355,292,82.25,63,17.75
4302,43,2,734,597,81.34,137,18.66
4303,43,3,651,515,79.11,136,20.89
4304,43,4,865,716,82.77,149,17.23
4305,43,5,639,520,81.38,119,18.62
4306,43,6,534,449,84.08,85,15.92
4307,43,7,387,327,84.5,60,15.5
4308,43,8,511,412,80.63,99,19.37
4309,43,9,674,531,78.78,143,21.22
4310,43,10,832,638,76.68,194,23.32
4311,43,11,657,533,81.13,124,18.87
4312,43,12,436,369,84.63,67,15.37
4313,43,13,653,566,86.68,87,13.32
4314,43,14,659,517,78.45,142,21.55
4315,43,15,683,565,82.72,118,17.28
4316,43,16,992,814,82.06,178,17.94
4317,43,17,532,420,78.95,112,21.05
4318,43,18,792,623,78.66,169,21.34
4319,43,19,677,545,80.5,132,19.5
4320,43,20,837,696,83.15,141,16.85
4321,43,21,802,663,82.67,139,17.33
4322,43,22,498,418,83.94,80,16.06
4323,43,23,471,379,80.47,92,19.53
4324,43,24,509,407,79.96,102,20.04
4325,43,25,553,451,81.56,102,18.44
4326,43,26,414,340,82.13,74,17.87
4327,43,27,607,482,79.41,125,20.59
4328,43,28,847,720,85.01,127,14.99
4329,43,29,956,800,83.68,156,16.32
4330,43,30,705,600,85.11,105,14.89
4331,43,31,633,520,82.15,113,17.85
4332,43,32,695,593,85.32,102,14.68
4333,43,33,654,503,76.91,151,23.09
4334,43,34,435,358,82.3,77,17.7
4335,43,35,708,560,79.1,148,20.9
4336,43,36,456,382,83.77,74,16.23
4337,43,37,776,683,88.02,93,11.98
4338,43,38,496,365,73.59,131,26.41
4339,43,39,535,437,81.68,98,18.32
4340,43,40,502,432,86.06,70,13.94
4341,43,41,815,674,82.7,141,17.3
4342,43,42,641,539,84.09,102,15.91
4343,43,43,694,539,77.67,155,22.33
4344,43,44,682,532,78.01,150,21.99
4345,43,45,397,328,82.62,69,17.38
4346,43,46,435,361,82.99,74,17.01
4401,44,1,1076,965,89.68,111,10.32
4402,44,2,755,641,84.9,114,15.1
4403,44,3,380,327,86.05,53,13.95
4404,44,4,573,495,86.39,78,13.61
4405,44,5,712,645,90.59,67,9.41
4406,44,6,940,813,86.49,127,13.51
4407,44,7,466,362,77.68,104,22.32
4408,44,8,985,882,89.54,103,10.46
4409,44,9,745,625,83.89,120,16.11
4410,44,10,778,673,86.5,105,13.5
4411,44,11,839,701,83.55,138,16.45
4412,44,12,740,626,84.59,114,15.41
4413,44,13,639,522,81.69,117,18.31
4414,44,14,696,609,87.5,87,12.5
4415,44,15,675,596,88.3,79,11.7
4416,44,16,852,717,84.15,135,15.85
4417,44,17,938,822,87.63,116,12.37
4418,44,18,823,707,85.91,116,14.09
4419,44,19,845,747,88.4,98,11.6
4420,44,20,883,785,88.9,98,11.1
4421,44,21,853,749,87.81,104,12.19
4422,44,22,665,580,87.22,85,12.78
4423,44,23,683,619,90.63,64,9.37
4424,44,24,500,432,86.4,68,13.6
4425,44,25,762,647,84.91,115,15.09
4426,44,26,887,793,89.4,94,10.6
4427,44,27,837,714,85.3,123,14.7
4428,44,28,757,676,89.3,81,10.7
4429,44,29,853,740,86.75,113,13.25
4430,44,30,894,773,86.47,121,13.53
4431,44,31,652,557,85.43,95,14.57
4432,44,32,853,731,85.7,122,14.3
4433,44,33,763,699,91.61,64,8.39
4434,44,34,757,678,89.56,79,10.44
4435,44,35,823,696,84.57,127,15.43
4436,44,36,828,702,84.78,126,15.22
4437,44,37,786,684,87.02,102,12.98
4438,44,38,925,788,85.19,137,14.81
4439,44,39,800,700,87.5,100,12.5
4440,44,40,739,601,81.33,138,18.67
4441,44,41,945,847,89.63,98,10.37
4501,45,1,474,414,87.34,60,12.66
4502,45,2,569,526,92.44,43,7.56
4503,45,3,517,443,85.69,74,14.31
4504,45,4,671,551,82.12,120,17.88
4505,45,5,591,485,82.06,106,17.94
4506,45,6,763,644,84.4,119,15.6
4507,45,7,808,683,84.53,125,15.47
4508,45,8,581,501,86.23,80,13.77
4509,45,9,578,498,86.16,80,13.84
4510,45,10,566,459,81.1,107,18.9
4511,45,11,443,379,85.55,64,14.45
4512,45,12,538,447,83.09,91,16.91
4513,45,13,466,389,83.48,77,16.52
4514,45,14,798,676,84.71,122,15.29
4515,45,15,660,567,85.91,93,14.09
4516,45,16,461,367,79.61,94,20.39
4517,45,17,634,509,80.28,125,19.72
4518,45,18,628,503,80.1,125,19.9
4519,45,19,323,271,83.9,52,16.1
4520,45,20,413,352,85.23,61,14.77
4521,45,21,512,400,78.13,112,21.88
4522,45,22,545,434,79.63,111,20.37
4523,45,23,535,393,73.46,142,26.54
4524,45,24,446,312,69.96,134,30.04
4525,45,25,369,272,73.71,97,26.29
4526,45,26,316,214,67.72,102,32.28
4527,45,27,565,416,73.63,149,26.37
4528,45,28,488,386,79.1,102,20.9
4529,45,29,371,292,78.71,79,21.29
4530,45,30,538,475,88.29,63,11.71
4531,45,31,461,392,85.03,69,14.97
4532,45,32,524,425,81.11,99,18.89
4533,45,33,405,334,82.47,71,17.53
4534,45,34,575,462,80.35,113,19.65
4535,45,35,608,467,76.81,141,23.19
4536,45,36,591,450,76.14,141,23.86
4537,45,37,544,404,74.26,140,25.74
4538,45,38,559,421,75.31,138,24.69
4539,45,39,562,422,75.09,140,24.91
4540,45,40,507,357,70.41,150,29.59
4541,45,41,515,368,71.46,147,28.54
4542,45,42,528,373,70.64,155,29.36
4543,45,43,576,374,64.93,202,35.07
4544,45,44,532,368,69.17,164,30.83
4545,45,45,386,224,58.03,162,41.97
4546,45,46,437,298,68.19,139,31.81
4547,45,47,418,278,66.51,140,33.49
4548,45,48,456,304,66.67,152,33.33
4601,46,1,488,429,87.91,59,12.09
4602,46,2,641,591,92.2,50,7.8
4603,46,3,774,674,87.08,100,12.92
4604,46,4,639,589,92.18,50,7.82
4605,46,5,897,803,89.52,94,10.48
4606,46,6,580,541,93.28,39,6.72
4607,46,7,668,602,90.12,66,9.88
4608,46,8,448,419,93.53,29,6.47
4609,46,9,719,660,91.79,59,8.21
4610,46,10,1170,1034,88.38,136,11.62
4611,46,11,668,596,89.22,72,10.78
4612,46,12,708,659,93.08,49,6.92
4613,46,13,690,616,89.28,74,10.72
4614,46,14,678,634,93.51,44,6.49
4615,46,15,705,628,89.08,77,10.92
4616,46,16,715,649,90.77,66,9.23
4617,46,17,724,636,87.85,88,12.15
4618,46,18,779,671,86.14,108,13.86
4619,46,19,456,401,87.94,55,12.06
4620,46,20,556,519,93.35,37,6.65
4621,46,21,478,439,91.84,39,8.16
4622,46,22,473,448,94.71,25,5.29
4623,46,23,587,545,92.84,42,7.16
4624,46,24,832,733,88.1,99,11.9
4625,46,25,637,593,93.09,44,6.91
4626,46,26,941,866,92.03,75,7.97
4627,46,27,875,800,91.43,75,8.57
4628,46,28,615,528,85.85,87,14.15
4629,46,29,555,493,88.83,62,11.17
4630,46,30,687,619,90.1,68,9.9
4631,46,31,698,646,92.55,52,7.45
4632,46,32,640,595,92.97,45,7.03
4633,46,33,716,644,89.94,72,10.06
4634,46,34,836,761,91.03,75,8.97
4635,46,35,740,681,92.03,59,7.97
4636,46,36,634,543,85.65,91,14.35
4637,46,37,519,490,94.41,29,5.59
4638,46,38,773,710,91.85,63,8.15
4639,46,39,640,549,85.78,91,14.22
4640,46,40,537,499,92.92,38,7.08
4701,47,1,473,414,87.53,59,12.47
4702,47,2,675,552,81.78,123,18.22
4703,47,3,648,564,87.04,84,12.96
4704,47,4,799,688,86.11,111,13.89
4705,47,5,727,662,91.06,65,8.94
4706,47,6,842,752,89.31,90,10.69
4707,47,7,662,574,86.71,88,13.29
4708,47,8,680,573,84.26,107,15.74
4709,47,9,681,597,87.67,84,12.33
4710,47,10,822,752,91.48,70,8.52
4711,47,11,721,612,84.88,109,15.12
4712,47,12,750,653,87.07,97,12.93
4713,47,13,660,587,88.94,73,11.06
4714,47,14,616,528,85.71,88,14.29
4715,47,15,802,751,93.64,51,6.36
4716,47,16,671,577,85.99,94,14.01
4717,47,17,708,610,86.16,98,13.84
4718,47,18,674,571,84.72,103,15.28
4719,47,19,1050,985,93.81,65,6.19
4720,47,20,697,621,89.1,76,10.9
4721,47,21,650,574,88.31,76,11.69
4722,47,22,729,635,87.11,94,12.89
4723,47,23,764,705,92.28,59,7.72
4724,47,24,751,667,88.81,84,11.19
4725,47,25,846,752,88.89,94,11.11
4726,47,26,904,833,92.15,71,7.85
4727,47,27,617,522,84.6,95,15.4
4728,47,28,626,558,89.14,68,10.86
4729,47,29,792,700,88.38,92,11.62
4730,47,30,846,780,92.2,66,7.8
4731,47,31,718,639,89.0,79,11.0
4732,47,32,818,752,91.93,66,8.07
4733,47,33,709,603,85.05,106,14.95
4734,47,34,704,620,88.07,84,11.93
4735,47,35,694,568,81.84,126,18.16
4736,47,36,765,699,91.37,66,8.63
4737,47,37,660,584,88.48,76,11.52
4738,47,38,696,620,89.08,76,10.92
4739,47,39,680,598,87.94,82,12.06
4740,47,40,635,575,90.55,60,9.45
4741,47,41,748,667,89.17,81,10.83
4742,47,42,655,583,89.01,72,10.99
4743,47,43,635,507,79.84,128,20.16
4744,47,44,634,558,88.01,76,11.99
4745,47,45,616,550,89.29,66,10.71
4746,47,46,726,606,83.47,120,16.53
4747,47,47,839,718,85.58,121,14.42
4748,47,48,41,34,82.93,7,17.07
4801,48,1,633,583,92.1,50,7.9
4802,48,2,290,248,85.52,42,14.48
4803,48,3,727,677,93.12,50,6.88
4804,48,4,619,586,94.67,33,5.33
4805,48,5,352,320,90.91,32,9.09
4806,48,6,756,711,94.05,45,5.95
4807,48,7,674,606,89.91,68,10.09
4808,48,8,323,277,85.76,46,14.24
4809,48,9,437,367,83.98,70,16.02
4810,48,10,884,820,92.76,64,7.24
4811,48,11,518,463,89.38,55,10.62
4812,48,12,732,681,93.03,51,6.97
4813,48,13,801,706,88.14,95,11.86
4814,48,14,304,263,86.51,41,13.49
4815,48,15,414,378,91.3,36,8.7
4816,48,16,684,636,92.98,48,7.02
4817,48,17,559,524,93.74,35,6.26
4818,48,18,428,397,92.76,31,7.24
4819,48,19,438,391,89.27,47,10.73
4820,48,20,667,613,91.9,54,8.1
4821,48,21,826,771,93.34,55,6.66
4822,48,22,508,455,89.57,53,10.43
4823,48,23,591,523,88.49,68,11.51
4824,48,24,764,638,83.51,126,16.49
4825,48,25,525,464,88.38,61,11.62
4826,48,26,312,285,91.35,27,8.65
4827,48,27,631,579,91.76,52,8.24
4828,48,28,721,655,90.85,66,9.15
4829,48,29,282,262,92.91,20,7.09
4830,48,30,524,473,90.27,51,9.73
4831,48,31,902,837,92.79,65,7.21
4832,48,32,701,659,94.01,42,5.99
4833,48,33,338,312,92.31,26,7.69
4834,48,34,538,494,91.82,44,8.18
4835,48,35,379,341,89.97,38,10.03
4836,48,36,348,302,86.78,46,13.22
4837,48,37,672,617,91.82,55,8.18
4838,48,38,639,563,88.11,76,11.89
4839,48,39,506,455,89.92,51,10.08
4840,48,40,563,510,90.59,53,9.41
4841,48,41,817,772,94.49,45,5.51
4842,48,42,695,658,94.68,37,5.32
4843,48,43,736,682,92.66,54,7.34
4844,48,44,787,725,92.12,62,7.88
4845,48,45,460,427,92.83,33,7.17
4846,48,46,407,365,89.68,42,10.32
4901,49,1,406,390,96.06,16,3.94
4902,49,2,401,381,95.01,20,4.99
4903,49,3,780,739,94.74,41,5.26
4904,49,4,824,769,93.33,55,6.67
4905,49,5,602,568,94.35,34,5.65
4906,49,6,562,520,92.53,42,7.47
4907,49,7,523,473,90.44,50,9.56
4908,49,8,569,531,93.32,38,6.68
4909,49,9,662,598,90.33,64,9.67
4910,49,10,714,661,92.58,53,7.42
4911,49,11,820,777,94.76,43,5.24
4912,49,12,776,720,92.78,56,7.22
4913,49,13,741,674,90.96,67,9.04
4914,49,14,504,466,92.46,38,7.54
4915,49,15,472,442,93.64,30,6.36
4916,49,16,589,536,91.0,53,9.0
4917,49,17,491,456,92.87,35,7.13
4918,49,18,806,753,93.42,53,6.58
4919,49,19,610,582,95.41,28,4.59
4920,49,20,947,894,94.4,53,5.6
4921,49,21,402,380,94.53,22,5.47
4922,49,22,663,604,91.1,59,8.9
4923,49,23,830,778,93.73,52,6.27
4924,49,24,521,494,94.82,27,5.18
4925,49,25,812,742,91.38,70,8.62
4926,49,26,744,696,93.55,48,6.45
4927,49,27,735,691,94.01,44,5.99
4928,49,28,903,848,93.91,55,6.09
4929,49,29,736,692,94.02,44,5.98
4930,49,30,665,615,92.48,50,7.52
4931,49,31,468,422,90.17,46,9.83
4932,49,32,601,567,94.34,34,5.66
4933,49,33,500,476,95.2,24,4.8
5001,50,1,491,316,64.36,175,35.64
5002,50,2,315,226,71.75,89,28.25
5003,50,3,443,317,71.56,126,28.44
5004,50,4,573,479,83.6,94,16.4
5005,50,5,351,235,66.95,116,33.05
5006,50,6,518,449,86.68,69,13.32
5007,50,7,582,527,90.55,55,9.45
5008,50,8,506,475,93.87,31,6.13
5009,50,9,412,344,83.5,68,16.5
5010,50,10,557,423,75.94,134,24.06
5011,50,11,325,152,46.77,173,53.23
5012,50,12,222,167,75.23,55,24.77
5013,50,13,584,543,92.98,41,7.02
5014,50,14,173,127,73.41,46,26.59
5015,50,15,578,488,84.43,90,15.57
5016,50,16,157,115,73.25,42,26.75
5017,50,17,526,430,81.75,96,18.25
5018,50,18,88,58,65.91,30,34.09
5019,50,19,401,376,93.77,25,6.23
5020,50,20,539,476,88.31,63,11.69
5021,50,21,457,385,84.25,72,15.75
5022,50,22,462,360,77.92,102,22.08
5023,50,23,383,315,82.25,68,17.75
5024,50,24,392,219,55.87,173,44.13
5025,50,25,486,313,64.4,173,35.6
5026,50,26,540,474,87.78,66,12.22
5027,50,27,170,132,77.65,38,22.35
5028,50,28,545,512,93.94,33,6.06
5029,50,29,515,476,92.43,39,7.57
5030,50,30,406,377,92.86,29,7.14
5031,50,31,676,641,94.82,35,5.18
5032,50,32,565,532,94.16,33,5.84
5033,50,33,381,214,56.17,167,43.83
5034,50,34,668,527,78.89,141,21.11
5035,50,35,660,605,91.67,55,8.33
5036,50,36,504,439,87.1,65,12.9
5037,50,37,516,468,90.7,48,9.3
5038,50,38,201,163,81.09,38,18.91
5039,50,39,332,250,75.3,82,24.7
5040,50,40,484,237,48.97,247,51.03
