id,ward,precinct,total,Iris Y. Martinez,Iris Y. Martinez Percent,Barbara Bellar,Barbara Bellar Percent
0101,1,1,667,572,85.76,95,14.24
0102,1,2,574,518,90.24,56,9.76
0103,1,3,766,651,84.99,115,15.01
0104,1,4,752,627,83.38,125,16.62
0105,1,5,699,573,81.97,126,18.03
0106,1,6,589,481,81.66,108,18.34
0107,1,7,452,394,87.17,58,12.83
0108,1,8,568,479,84.33,89,15.67
0109,1,9,466,403,86.48,63,13.52
0110,1,10,835,684,81.92,151,18.08
0111,1,11,747,636,85.14,111,14.86
0112,1,12,801,640,79.9,161,20.1
0113,1,13,327,278,85.02,49,14.98
0114,1,14,636,535,84.12,101,15.88
0115,1,15,593,491,82.8,102,17.2
0116,1,16,713,628,88.08,85,11.92
0117,1,17,571,501,87.74,70,12.26
0118,1,18,642,589,91.74,53,8.26
0119,1,19,763,688,90.17,75,9.83
0120,1,20,509,466,91.55,43,8.45
0121,1,21,932,782,83.91,150,16.09
0122,1,22,454,391,86.12,63,13.88
0123,1,23,834,744,89.21,90,10.79
0124,1,24,601,544,90.52,57,9.48
0125,1,25,648,569,87.81,79,12.19
0126,1,26,442,386,87.33,56,12.67
0127,1,27,712,593,83.29,119,16.71
0128,1,28,223,190,85.2,33,14.8
0129,1,29,850,727,85.53,123,14.47
0130,1,30,738,663,89.84,75,10.16
0131,1,31,592,520,87.84,72,12.16
0132,1,32,628,501,79.78,127,20.22
0133,1,33,742,587,79.11,155,20.89
0134,1,34,515,465,90.29,50,9.71
0135,1,35,823,653,79.34,170,20.66
0136,1,36,755,618,81.85,137,18.15
0137,1,37,691,555,80.32,136,19.68
0138,1,38,630,546,86.67,84,13.33
0139,1,39,536,447,83.4,89,16.6
0140,1,40,587,482,82.11,105,17.89
0141,1,41,374,339,90.64,35,9.36
0142,1,42,215,180,83.72,35,16.28
0143,1,43,417,356,85.37,61,14.63
0144,1,44,592,516,87.16,76,12.84
0201,2,1,739,618,83.63,121,16.37
0202,2,2,464,326,70.26,138,29.74
0203,2,3,749,624,83.31,125,16.69
0204,2,4,664,578,87.05,86,12.95
0205,2,5,779,633,81.26,146,18.74
0206,2,6,707,586,82.89,121,17.11
0207,2,7,622,511,82.15,111,17.85
0208,2,8,836,698,83.49,138,16.51
0209,2,9,647,430,66.46,217,33.54
0210,2,10,474,295,62.24,179,37.76
0211,2,11,658,447,67.93,211,32.07
0212,2,12,543,444,81.77,99,18.23
0213,2,13,516,370,71.71,146,28.29
0214,2,14,652,537,82.36,115,17.64
0215,2,15,604,503,83.28,101,16.72
0216,2,16,641,522,81.44,119,18.56
0217,2,17,723,585,80.91,138,19.09
0218,2,18,582,406,69.76,176,30.24
0219,2,19,415,266,64.1,149,35.9
0220,2,20,854,620,72.6,234,27.4
0221,2,21,700,599,85.57,101,14.43
0222,2,22,681,465,68.28,216,31.72
0223,2,23,418,286,68.42,132,31.58
0224,2,24,574,422,73.52,152,26.48
0225,2,25,750,607,80.93,143,19.07
0226,2,26,570,408,71.58,162,28.42
0227,2,27,565,344,60.88,221,39.12
0228,2,28,738,535,72.49,203,27.51
0229,2,29,706,483,68.41,223,31.59
0230,2,30,537,350,65.18,187,34.82
0231,2,31,705,476,67.52,229,32.48
0232,2,32,555,366,65.95,189,34.05
0233,2,33,886,609,68.74,277,31.26
0234,2,34,454,299,65.86,155,34.14
0235,2,35,865,593,68.55,272,31.45
0236,2,36,716,485,67.74,231,32.26
0237,2,37,531,381,71.75,150,28.25
0238,2,38,578,371,64.19,207,35.81
0239,2,39,448,255,56.92,193,43.08
0240,2,40,906,623,68.76,283,31.24
0241,2,41,775,507,65.42,268,34.58
0242,2,42,728,518,71.15,210,28.85
0243,2,43,868,556,64.06,312,35.94
0244,2,44,382,253,66.23,129,33.77
0245,2,45,748,558,74.6,190,25.4
0246,2,46,367,250,68.12,117,31.88
0301,3,1,760,720,94.74,40,5.26
0302,3,2,584,550,94.18,34,5.82
0303,3,3,485,419,86.39,66,13.61
0304,3,4,626,606,96.81,20,3.19
0305,3,5,325,294,90.46,31,9.54
0306,3,6,849,656,77.27,193,22.73
0307,3,7,336,309,91.96,27,8.04
0308,3,8,423,391,92.43,32,7.57
0309,3,9,644,613,95.19,31,4.81
0310,3,10,282,264,93.62,18,6.38
0311,3,11,604,581,96.19,23,3.81
0312,3,12,532,509,95.68,23,4.32
0313,3,13,719,586,81.5,133,18.5
0314,3,14,699,594,84.98,105,15.02
0315,3,15,542,517,95.39,25,4.61
0316,3,16,454,426,93.83,28,6.17
0317,3,17,877,783,89.28,94,10.72
0318,3,18,772,720,93.26,52,6.74
0319,3,19,748,557,74.47,191,25.53
0320,3,20,593,560,94.44,33,5.56
0321,3,21,633,485,76.62,148,23.38
0322,3,22,863,674,78.1,189,21.9
0323,3,23,478,426,89.12,52,10.88
0324,3,24,479,454,94.78,25,5.22
0325,3,25,1095,799,72.97,296,27.03
0326,3,26,700,561,80.14,139,19.86
0327,3,27,806,584,72.46,222,27.54
0328,3,28,292,271,92.81,21,7.19
0329,3,29,599,564,94.16,35,5.84
0330,3,30,478,463,96.86,15,3.14
0331,3,31,656,622,94.82,34,5.18
0332,3,32,993,814,81.97,179,18.03
0333,3,33,786,642,81.68,144,18.32
0334,3,34,922,756,82.0,166,18.0
0335,3,35,303,287,94.72,16,5.28
0336,3,36,275,264,96.0,11,4.0
0337,3,37,505,476,94.26,29,5.74
0338,3,38,398,375,94.22,23,5.78
0339,3,39,1208,975,80.71,233,19.29
0340,3,40,622,538,86.5,84,13.5
0341,3,41,415,365,87.95,50,12.05
0401,4,1,867,803,92.62,64,7.38
0402,4,2,829,678,81.79,151,18.21
0403,4,3,484,469,96.9,15,3.1
0404,4,4,749,692,92.39,57,7.61
0405,4,5,605,573,94.71,32,5.29
0406,4,6,660,596,90.3,64,9.7
0407,4,7,728,691,94.92,37,5.08
0408,4,8,635,617,97.17,18,2.83
0409,4,9,618,588,95.15,30,4.85
0410,4,10,747,717,95.98,30,4.02
0411,4,11,601,573,95.34,28,4.66
0412,4,12,755,723,95.76,32,4.24
0413,4,13,855,705,82.46,150,17.54
0414,4,14,588,545,92.69,43,7.31
0415,4,15,660,623,94.39,37,5.61
0416,4,16,1115,920,82.51,195,17.49
0417,4,17,722,612,84.76,110,15.24
0418,4,18,553,522,94.39,31,5.61
0419,4,19,449,418,93.1,31,6.9
0420,4,20,513,408,79.53,105,20.47
0421,4,21,714,596,83.47,118,16.53
0422,4,22,562,523,93.06,39,6.94
0423,4,23,721,683,94.73,38,5.27
0424,4,24,553,517,93.49,36,6.51
0425,4,25,811,674,83.11,137,16.89
0426,4,26,528,489,92.61,39,7.39
0427,4,27,793,748,94.33,45,5.67
0428,4,28,528,492,93.18,36,6.82
0429,4,29,556,525,94.42,31,5.58
0430,4,30,798,767,96.12,31,3.88
0431,4,31,536,502,93.66,34,6.34
0432,4,32,649,615,94.76,34,5.24
0433,4,33,555,523,94.23,32,5.77
0434,4,34,541,506,93.53,35,6.47
0435,4,35,668,624,93.41,44,6.59
0436,4,36,730,687,94.11,43,5.89
0437,4,37,1170,975,83.33,195,16.67
0438,4,38,643,611,95.02,32,4.98
0501,5,1,495,473,95.56,22,4.44
0502,5,2,408,393,96.32,15,3.68
0503,5,3,558,533,95.52,25,4.48
0504,5,4,729,696,95.47,33,4.53
0505,5,5,496,474,95.56,22,4.44
0506,5,6,427,399,93.44,28,6.56
0507,5,7,560,527,94.11,33,5.89
0508,5,8,574,518,90.24,56,9.76
0509,5,9,644,612,95.03,32,4.97
0510,5,10,448,428,95.54,20,4.46
0511,5,11,553,507,91.68,46,8.32
0512,5,12,345,319,92.46,26,7.54
0513,5,13,472,451,95.55,21,4.45
0514,5,14,424,408,96.23,16,3.77
0515,5,15,549,503,91.62,46,8.38
0516,5,16,504,482,95.63,22,4.37
0517,5,17,439,414,94.31,25,5.69
0518,5,18,520,492,94.62,28,5.38
0519,5,19,494,457,92.51,37,7.49
0520,5,20,593,558,94.1,35,5.9
0521,5,21,562,522,92.88,40,7.12
0522,5,22,657,608,92.54,49,7.46
0523,5,23,970,891,91.86,79,8.14
0524,5,24,689,652,94.63,37,5.37
0525,5,25,505,475,94.06,30,5.94
0526,5,26,530,494,93.21,36,6.79
0527,5,27,563,502,89.17,61,10.83
0528,5,28,543,512,94.29,31,5.71
0529,5,29,564,537,95.21,27,4.79
0530,5,30,348,329,94.54,19,5.46
0531,5,31,401,383,95.51,18,4.49
0532,5,32,597,566,94.81,31,5.19
0533,5,33,563,538,95.56,25,4.44
0534,5,34,599,536,89.48,63,10.52
0535,5,35,698,652,93.41,46,6.59
0536,5,36,342,325,95.03,17,4.97
0537,5,37,575,534,92.87,41,7.13
0538,5,38,491,465,94.7,26,5.3
0539,5,39,465,405,87.1,60,12.9
0540,5,40,414,386,93.24,28,6.76
0541,5,41,254,243,95.67,11,4.33
0601,6,1,464,447,96.34,17,3.66
0602,6,2,446,438,98.21,8,1.79
0603,6,3,450,431,95.78,19,4.22
0604,6,4,308,291,94.48,17,5.52
0605,6,5,291,279,95.88,12,4.12
0606,6,6,503,482,95.83,21,4.17
0607,6,7,429,396,92.31,33,7.69
0608,6,8,441,425,96.37,16,3.63
0609,6,9,436,414,94.95,22,5.05
0610,6,10,312,287,91.99,25,8.01
0611,6,11,378,358,94.71,20,5.29
0612,6,12,328,304,92.68,24,7.32
0613,6,13,330,318,96.36,12,3.64
0614,6,14,403,392,97.27,11,2.73
0615,6,15,378,348,92.06,30,7.94
0616,6,16,457,436,95.4,21,4.6
0617,6,17,309,269,87.06,40,12.94
0618,6,18,315,291,92.38,24,7.62
0619,6,19,354,342,96.61,12,3.39
0620,6,20,292,280,95.89,12,4.11
0621,6,21,204,188,92.16,16,7.84
0622,6,22,275,260,94.55,15,5.45
0623,6,23,224,206,91.96,18,8.04
0624,6,24,226,202,89.38,24,10.62
0625,6,25,227,212,93.39,15,6.61
0626,6,26,333,303,90.99,30,9.01
0627,6,27,267,246,92.13,21,7.87
0628,6,28,222,210,94.59,12,5.41
0629,6,29,447,427,95.53,20,4.47
0630,6,30,367,347,94.55,20,5.45
0631,6,31,446,424,95.07,22,4.93
0632,6,32,431,413,95.82,18,4.18
0633,6,33,425,393,92.47,32,7.53
0634,6,34,433,421,97.23,12,2.77
0635,6,35,394,374,94.92,20,5.08
0636,6,36,473,456,96.41,17,3.59
0637,6,37,468,442,94.44,26,5.56
0638,6,38,463,440,95.03,23,4.97
0639,6,39,355,335,94.37,20,5.63
0640,6,40,377,361,95.76,16,4.24
0641,6,41,427,402,94.15,25,5.85
0642,6,42,432,410,94.91,22,5.09
0643,6,43,404,384,95.05,20,4.95
0644,6,44,495,463,93.54,32,6.46
0645,6,45,420,411,97.86,9,2.14
0646,6,46,322,302,93.79,20,6.21
0647,6,47,316,295,93.35,21,6.65
0648,6,48,421,401,95.25,20,4.75
0701,7,1,418,393,94.02,25,5.98
0702,7,2,415,397,95.66,18,4.34
0703,7,3,413,399,96.61,14,3.39
0704,7,4,413,396,95.88,17,4.12
0705,7,5,374,348,93.05,26,6.95
0706,7,6,544,527,96.88,17,3.13
0707,7,7,411,384,93.43,27,6.57
0708,7,8,335,310,92.54,25,7.46
0709,7,9,707,661,93.49,46,6.51
0710,7,10,484,471,97.31,13,2.69
0711,7,11,476,452,94.96,24,5.04
0712,7,12,396,371,93.69,25,6.31
0713,7,13,233,220,94.42,13,5.58
0714,7,14,480,456,95.0,24,5.0
0715,7,15,407,395,97.05,12,2.95
0716,7,16,409,380,92.91,29,7.09
0717,7,17,336,318,94.64,18,5.36
0718,7,18,391,370,94.63,21,5.37
0719,7,19,386,368,95.34,18,4.66
0720,7,20,331,311,93.96,20,6.04
0721,7,21,318,301,94.65,17,5.35
0722,7,22,367,329,89.65,38,10.35
0723,7,23,396,378,95.45,18,4.55
0724,7,24,351,332,94.59,19,5.41
0725,7,25,343,308,89.8,35,10.2
0726,7,26,332,320,96.39,12,3.61
0727,7,27,335,327,97.61,8,2.39
0728,7,28,326,305,93.56,21,6.44
0729,7,29,373,353,94.64,20,5.36
0730,7,30,322,300,93.17,22,6.83
0731,7,31,302,280,92.72,22,7.28
0732,7,32,512,491,95.9,21,4.1
0733,7,33,490,468,95.51,22,4.49
0734,7,34,512,492,96.09,20,3.91
0735,7,35,452,435,96.24,17,3.76
0736,7,36,502,478,95.22,24,4.78
0737,7,37,413,394,95.4,19,4.6
0738,7,38,358,343,95.81,15,4.19
0739,7,39,385,365,94.81,20,5.19
0740,7,40,361,348,96.4,13,3.6
0741,7,41,395,372,94.18,23,5.82
0742,7,42,383,373,97.39,10,2.61
0743,7,43,395,377,95.44,18,4.56
0744,7,44,362,349,96.41,13,3.59
0745,7,45,397,376,94.71,21,5.29
0746,7,46,123,113,91.87,10,8.13
0801,8,1,374,351,93.85,23,6.15
0802,8,2,397,377,94.96,20,5.04
0803,8,3,469,454,96.8,15,3.2
0804,8,4,473,466,98.52,7,1.48
0805,8,5,465,451,96.99,14,3.01
0806,8,6,422,399,94.55,23,5.45
0807,8,7,483,464,96.07,19,3.93
0808,8,8,429,418,97.44,11,2.56
0809,8,9,284,271,95.42,13,4.58
0810,8,10,518,503,97.1,15,2.9
0811,8,11,350,336,96.0,14,4.0
0812,8,12,374,358,95.72,16,4.28
0813,8,13,496,466,93.95,30,6.05
0814,8,14,351,324,92.31,27,7.69
0815,8,15,396,373,94.19,23,5.81
0816,8,16,138,127,92.03,11,7.97
0817,8,17,356,346,97.19,10,2.81
0818,8,18,408,374,91.67,34,8.33
0819,8,19,457,440,96.28,17,3.72
0820,8,20,477,462,96.86,15,3.14
0821,8,21,553,528,95.48,25,4.52
0822,8,22,384,363,94.53,21,5.47
0823,8,23,334,322,96.41,12,3.59
0824,8,24,240,234,97.5,6,2.5
0825,8,25,423,399,94.33,24,5.67
0826,8,26,370,342,92.43,28,7.57
0827,8,27,463,444,95.9,19,4.1
0828,8,28,425,400,94.12,25,5.88
0829,8,29,473,451,95.35,22,4.65
0830,8,30,473,448,94.71,25,5.29
0831,8,31,329,312,94.83,17,5.17
0832,8,32,337,327,97.03,10,2.97
0833,8,33,348,325,93.39,23,6.61
0834,8,34,394,384,97.46,10,2.54
0835,8,35,488,468,95.9,20,4.1
0836,8,36,432,408,94.44,24,5.56
0837,8,37,346,338,97.69,8,2.31
0838,8,38,308,297,96.43,11,3.57
0839,8,39,416,406,97.6,10,2.4
0840,8,40,353,338,95.75,15,4.25
0841,8,41,459,440,95.86,19,4.14
0842,8,42,546,526,96.34,20,3.66
0843,8,43,245,228,93.06,17,6.94
0844,8,44,299,277,92.64,22,7.36
0845,8,45,360,339,94.17,21,5.83
0846,8,46,343,326,95.04,17,4.96
0847,8,47,358,339,94.69,19,5.31
0848,8,48,387,374,96.64,13,3.36
0849,8,49,391,380,97.19,11,2.81
0850,8,50,422,405,95.97,17,4.03
0851,8,51,422,410,97.16,12,2.84
0852,8,52,522,503,96.36,19,3.64
0853,8,53,266,255,95.86,11,4.14
0854,8,54,358,326,91.06,32,8.94
0855,8,55,326,314,96.32,12,3.68
0856,8,56,436,422,96.79,14,3.21
0901,9,1,396,379,95.71,17,4.29
0902,9,2,324,307,94.75,17,5.25
0903,9,3,279,259,92.83,20,7.17
0904,9,4,324,318,98.15,6,1.85
0905,9,5,402,389,96.77,13,3.23
0906,9,6,382,363,95.03,19,4.97
0907,9,7,315,296,93.97,19,6.03
0908,9,8,430,402,93.49,28,6.51
0909,9,9,477,460,96.44,17,3.56
0910,9,10,312,296,94.87,16,5.13
0911,9,11,292,270,92.47,22,7.53
0912,9,12,455,424,93.19,31,6.81
0913,9,13,444,428,96.4,16,3.6
0914,9,14,454,438,96.48,16,3.52
0915,9,15,485,447,92.16,38,7.84
0916,9,16,391,375,95.91,16,4.09
0917,9,17,299,285,95.32,14,4.68
0918,9,18,296,287,96.96,9,3.04
0919,9,19,410,391,95.37,19,4.63
0920,9,20,382,371,97.12,11,2.88
0921,9,21,379,351,92.61,28,7.39
0922,9,22,432,411,95.14,21,4.86
0923,9,23,458,443,96.72,15,3.28
0924,9,24,402,382,95.02,20,4.98
0925,9,25,391,379,96.93,12,3.07
0926,9,26,507,474,93.49,33,6.51
0927,9,27,339,316,93.22,23,6.78
0928,9,28,278,256,92.09,22,7.91
0929,9,29,366,349,95.36,17,4.64
0930,9,30,343,317,92.42,26,7.58
0931,9,31,341,324,95.01,17,4.99
0932,9,32,410,390,95.12,20,4.88
0933,9,33,302,283,93.71,19,6.29
0934,9,34,338,318,94.08,20,5.92
0935,9,35,376,362,96.28,14,3.72
0936,9,36,355,339,95.49,16,4.51
0937,9,37,610,524,85.9,86,14.1
0938,9,38,386,370,95.85,16,4.15
0939,9,39,431,416,96.52,15,3.48
0940,9,40,443,425,95.94,18,4.06
0941,9,41,328,315,96.04,13,3.96
0942,9,42,422,406,96.21,16,3.79
0943,9,43,351,331,94.3,20,5.7
0944,9,44,352,342,97.16,10,2.84
0945,9,45,317,296,93.38,21,6.62
0946,9,46,385,364,94.55,21,5.45
0947,9,47,423,410,96.93,13,3.07
0948,9,48,417,393,94.24,24,5.76
0949,9,49,439,419,95.44,20,4.56
0950,9,50,567,545,96.12,22,3.88
0951,9,51,394,377,95.69,17,4.31
1001,10,1,348,313,89.94,35,10.06
1002,10,2,447,302,67.56,145,32.44
1003,10,3,471,324,68.79,147,31.21
1004,10,4,342,317,92.69,25,7.31
1005,10,5,376,263,69.95,113,30.05
1006,10,6,376,303,80.59,73,19.41
1007,10,7,327,277,84.71,50,15.29
1008,10,8,224,211,94.2,13,5.8
1009,10,9,447,304,68.01,143,31.99
1010,10,10,502,392,78.09,110,21.91
1011,10,11,584,490,83.9,94,16.1
1012,10,12,333,268,80.48,65,19.52
1013,10,13,413,372,90.07,41,9.93
1014,10,14,572,468,81.82,104,18.18
1015,10,15,743,714,96.1,29,3.9
1016,10,16,351,262,74.64,89,25.36
1017,10,17,591,394,66.67,197,33.33
1018,10,18,259,245,94.59,14,5.41
1019,10,19,474,360,75.95,114,24.05
1020,10,20,477,381,79.87,96,20.13
1021,10,21,469,370,78.89,99,21.11
1022,10,22,265,234,88.3,31,11.7
1023,10,23,399,342,85.71,57,14.29
1024,10,24,468,292,62.39,176,37.61
1025,10,25,127,121,95.28,6,4.72
1026,10,26,329,299,90.88,30,9.12
1027,10,27,384,359,93.49,25,6.51
1028,10,28,520,454,87.31,66,12.69
1029,10,29,473,391,82.66,82,17.34
1030,10,30,421,362,85.99,59,14.01
1031,10,31,382,339,88.74,43,11.26
1032,10,32,471,388,82.38,83,17.62
1033,10,33,356,315,88.48,41,11.52
1034,10,34,304,271,89.14,33,10.86
1035,10,35,501,365,72.85,136,27.15
1036,10,36,114,106,92.98,8,7.02
1101,11,1,550,402,73.09,148,26.91
1102,11,2,41,28,68.29,13,31.71
1103,11,3,538,483,89.78,55,10.22
1104,11,4,433,343,79.21,90,20.79
1105,11,5,697,573,82.21,124,17.79
1106,11,6,848,693,81.72,155,18.28
1107,11,7,511,434,84.93,77,15.07
1108,11,8,490,376,76.73,114,23.27
1109,11,9,455,323,70.99,132,29.01
1110,11,10,520,358,68.85,162,31.15
1111,11,11,596,422,70.81,174,29.19
1112,11,12,680,365,53.68,315,46.32
1113,11,13,639,336,52.58,303,47.42
1114,11,14,294,180,61.22,114,38.78
1115,11,15,207,155,74.88,52,25.12
1116,11,16,389,238,61.18,151,38.82
1117,11,17,649,500,77.04,149,22.96
1118,11,18,437,294,67.28,143,32.72
1119,11,19,694,560,80.69,134,19.31
1120,11,20,372,247,66.4,125,33.6
1121,11,21,639,425,66.51,214,33.49
1122,11,22,656,476,72.56,180,27.44
1123,11,23,298,192,64.43,106,35.57
1124,11,24,579,397,68.57,182,31.43
1125,11,25,656,486,74.09,170,25.91
1126,11,26,557,399,71.63,158,28.37
1127,11,27,218,152,69.72,66,30.28
1128,11,28,260,166,63.85,94,36.15
1129,11,29,627,387,61.72,240,38.28
1130,11,30,290,196,67.59,94,32.41
1131,11,31,542,326,60.15,216,39.85
1132,11,32,237,136,57.38,101,42.62
1133,11,33,699,533,76.25,166,23.75
1134,11,34,172,111,64.53,61,35.47
1135,11,35,89,58,65.17,31,34.83
1136,11,36,251,162,64.54,89,35.46
1137,11,37,160,119,74.38,41,25.63
1138,11,38,277,237,85.56,40,14.44
1201,12,1,461,390,84.6,71,15.4
1202,12,2,396,336,84.85,60,15.15
1203,12,3,561,476,84.85,85,15.15
1204,12,4,541,456,84.29,85,15.71
1205,12,5,428,312,72.9,116,27.1
1206,12,6,553,444,80.29,109,19.71
1207,12,7,435,404,92.87,31,7.13
1208,12,8,475,392,82.53,83,17.47
1209,12,9,400,326,81.5,74,18.5
1210,12,10,612,574,93.79,38,6.21
1211,12,11,513,452,88.11,61,11.89
1212,12,12,477,395,82.81,82,17.19
1213,12,13,510,437,85.69,73,14.31
1214,12,14,418,373,89.23,45,10.77
1215,12,15,425,380,89.41,45,10.59
1216,12,16,417,377,90.41,40,9.59
1217,12,17,554,482,87.0,72,13.0
1218,12,18,411,378,91.97,33,8.03
1219,12,19,461,387,83.95,74,16.05
1220,12,20,562,495,88.08,67,11.92
1221,12,21,500,430,86.0,70,14.0
1222,12,22,446,408,91.48,38,8.52
1223,12,23,478,398,83.26,80,16.74
1301,13,1,395,256,64.81,139,35.19
1302,13,2,327,200,61.16,127,38.84
1303,13,3,343,303,88.34,40,11.66
1304,13,4,449,264,58.8,185,41.2
1305,13,5,492,411,83.54,81,16.46
1306,13,6,398,212,53.27,186,46.73
1307,13,7,352,270,76.7,82,23.3
1308,13,8,321,213,66.36,108,33.64
1309,13,9,445,367,82.47,78,17.53
1310,13,10,367,168,45.78,199,54.22
1311,13,11,436,283,64.91,153,35.09
1312,13,12,388,307,79.12,81,20.88
1313,13,13,398,330,82.91,68,17.09
1314,13,14,400,317,79.25,83,20.75
1315,13,15,588,500,85.03,88,14.97
1316,13,16,305,273,89.51,32,10.49
1317,13,17,362,254,70.17,108,29.83
1318,13,18,349,210,60.17,139,39.83
1319,13,19,515,471,91.46,44,8.54
1320,13,20,301,162,53.82,139,46.18
1321,13,21,472,244,51.69,228,48.31
1322,13,22,461,260,56.4,201,43.6
1323,13,23,342,286,83.63,56,16.37
1324,13,24,418,318,76.08,100,23.92
1325,13,25,424,351,82.78,73,17.22
1326,13,26,435,322,74.02,113,25.98
1327,13,27,412,282,68.45,130,31.55
1328,13,28,320,259,80.94,61,19.06
1329,13,29,345,278,80.58,67,19.42
1330,13,30,328,296,90.24,32,9.76
1331,13,31,458,247,53.93,211,46.07
1332,13,32,363,186,51.24,177,48.76
1333,13,33,401,222,55.36,179,44.64
1334,13,34,406,366,90.15,40,9.85
1335,13,35,361,297,82.27,64,17.73
1336,13,36,298,256,85.91,42,14.09
1337,13,37,415,348,83.86,67,16.14
1338,13,38,350,195,55.71,155,44.29
1339,13,39,394,338,85.79,56,14.21
1340,13,40,408,307,75.25,101,24.75
1341,13,41,484,425,87.81,59,12.19
1342,13,42,428,227,53.04,201,46.96
1343,13,43,411,304,73.97,107,26.03
1344,13,44,429,378,88.11,51,11.89
1345,13,45,436,297,68.12,139,31.88
1346,13,46,478,404,84.52,74,15.48
1347,13,47,479,413,86.22,66,13.78
1348,13,48,364,214,58.79,150,41.21
1401,14,1,506,247,48.81,259,51.19
1402,14,2,612,503,82.19,109,17.81
1403,14,3,436,388,88.99,48,11.01
1404,14,4,470,246,52.34,224,47.66
1405,14,5,642,584,90.97,58,9.03
1406,14,6,247,218,88.26,29,11.74
1407,14,7,604,504,83.44,100,16.56
1408,14,8,557,451,80.97,106,19.03
1409,14,9,590,356,60.34,234,39.66
1410,14,10,338,275,81.36,63,18.64
1411,14,11,274,245,89.42,29,10.58
1412,14,12,499,380,76.15,119,23.85
1413,14,13,411,352,85.64,59,14.36
1414,14,14,436,393,90.14,43,9.86
1415,14,15,486,437,89.92,49,10.08
1416,14,16,329,275,83.59,54,16.41
1417,14,17,401,344,85.79,57,14.21
1418,14,18,220,168,76.36,52,23.64
1419,14,19,426,374,87.79,52,12.21
1420,14,20,352,298,84.66,54,15.34
1421,14,21,442,382,86.43,60,13.57
1422,14,22,641,471,73.48,170,26.52
1423,14,23,387,280,72.35,107,27.65
1424,14,24,539,309,57.33,230,42.67
1425,14,25,249,220,88.35,29,11.65
1426,14,26,342,315,92.11,27,7.89
1427,14,27,453,369,81.46,84,18.54
1428,14,28,384,322,83.85,62,16.15
1429,14,29,343,305,88.92,38,11.08
1430,14,30,306,281,91.83,25,8.17
1431,14,31,247,213,86.23,34,13.77
1501,15,1,389,348,89.46,41,10.54
1502,15,2,244,223,91.39,21,8.61
1503,15,3,264,247,93.56,17,6.44
1504,15,4,448,395,88.17,53,11.83
1505,15,5,411,369,89.78,42,10.22
1506,15,6,457,395,86.43,62,13.57
1507,15,7,248,222,89.52,26,10.48
1508,15,8,440,387,87.95,53,12.05
1509,15,9,598,527,88.13,71,11.87
1510,15,10,582,499,85.74,83,14.26
1511,15,11,544,472,86.76,72,13.24
1512,15,12,553,470,84.99,83,15.01
1513,15,13,434,377,86.87,57,13.13
1514,15,14,394,355,90.1,39,9.9
1515,15,15,401,349,87.03,52,12.97
1516,15,16,502,459,91.43,43,8.57
1517,15,17,244,225,92.21,19,7.79
1518,15,18,214,195,91.12,19,8.88
1519,15,19,365,330,90.41,35,9.59
1520,15,20,258,246,95.35,12,4.65
1521,15,21,208,189,90.87,19,9.13
1522,15,22,239,217,90.79,22,9.21
1523,15,23,274,257,93.8,17,6.2
1524,15,24,246,230,93.5,16,6.5
1601,16,1,541,491,90.76,50,9.24
1602,16,2,304,279,91.78,25,8.22
1603,16,3,288,279,96.88,9,3.13
1604,16,4,361,341,94.46,20,5.54
1605,16,5,239,228,95.4,11,4.6
1606,16,6,288,279,96.88,9,3.13
1607,16,7,334,314,94.01,20,5.99
1608,16,8,224,214,95.54,10,4.46
1609,16,9,303,284,93.73,19,6.27
1610,16,10,280,269,96.07,11,3.93
1611,16,11,337,308,91.39,29,8.61
1612,16,12,293,271,92.49,22,7.51
1613,16,13,393,361,91.86,32,8.14
1614,16,14,239,217,90.79,22,9.21
1615,16,15,301,281,93.36,20,6.64
1616,16,16,269,253,94.05,16,5.95
1617,16,17,456,422,92.54,34,7.46
1618,16,18,383,347,90.6,36,9.4
1619,16,19,327,304,92.97,23,7.03
1620,16,20,233,219,93.99,14,6.01
1621,16,21,270,254,94.07,16,5.93
1622,16,22,297,274,92.26,23,7.74
1623,16,23,461,419,90.89,42,9.11
1624,16,24,154,146,94.81,8,5.19
1625,16,25,370,340,91.89,30,8.11
1626,16,26,232,210,90.52,22,9.48
1627,16,27,236,224,94.92,12,5.08
1628,16,28,259,235,90.73,24,9.27
1629,16,29,253,239,94.47,14,5.53
1630,16,30,249,232,93.17,17,6.83
1631,16,31,287,263,91.64,24,8.36
1632,16,32,452,408,90.27,44,9.73
1633,16,33,249,233,93.57,16,6.43
1634,16,34,276,257,93.12,19,6.88
1635,16,35,484,437,90.29,47,9.71
1636,16,36,224,202,90.18,22,9.82
1701,17,1,445,408,91.69,37,8.31
1702,17,2,375,358,95.47,17,4.53
1703,17,3,388,360,92.78,28,7.22
1704,17,4,441,400,90.7,41,9.3
1705,17,5,301,278,92.36,23,7.64
1706,17,6,400,372,93.0,28,7.0
1707,17,7,394,368,93.4,26,6.6
1708,17,8,347,322,92.8,25,7.2
1709,17,9,308,290,94.16,18,5.84
1710,17,10,483,444,91.93,39,8.07
1711,17,11,299,280,93.65,19,6.35
1712,17,12,561,498,88.77,63,11.23
1713,17,13,304,291,95.72,13,4.28
1714,17,14,443,416,93.91,27,6.09
1715,17,15,399,375,93.98,24,6.02
1716,17,16,454,412,90.75,42,9.25
1717,17,17,393,357,90.84,36,9.16
1718,17,18,437,421,96.34,16,3.66
1719,17,19,237,220,92.83,17,7.17
1720,17,20,472,455,96.4,17,3.6
1721,17,21,443,426,96.16,17,3.84
1722,17,22,361,346,95.84,15,4.16
1723,17,23,257,244,94.94,13,5.06
1724,17,24,396,375,94.7,21,5.3
1725,17,25,301,279,92.69,22,7.31
1726,17,26,382,363,95.03,19,4.97
1727,17,27,356,334,93.82,22,6.18
1728,17,28,305,290,95.08,15,4.92
1729,17,29,368,348,94.57,20,5.43
1730,17,30,393,345,87.79,48,12.21
1731,17,31,237,232,97.89,5,2.11
1732,17,32,306,282,92.16,24,7.84
1733,17,33,216,195,90.28,21,9.72
1734,17,34,269,248,92.19,21,7.81
1735,17,35,263,252,95.82,11,4.18
1736,17,36,344,327,95.06,17,4.94
1737,17,37,307,288,93.81,19,6.19
1738,17,38,427,400,93.68,27,6.32
1739,17,39,370,348,94.05,22,5.95
1740,17,40,416,395,94.95,21,5.05
1741,17,41,500,470,94.0,30,6.0
1801,18,1,401,378,94.26,23,5.74
1802,18,2,490,421,85.92,69,14.08
1803,18,3,402,303,75.37,99,24.63
1804,18,4,459,436,94.99,23,5.01
1805,18,5,262,248,94.66,14,5.34
1806,18,6,406,306,75.37,100,24.63
1807,18,7,432,379,87.73,53,12.27
1808,18,8,426,398,93.43,28,6.57
1809,18,9,406,382,94.09,24,5.91
1810,18,10,530,503,94.91,27,5.09
1811,18,11,399,345,86.47,54,13.53
1812,18,12,396,372,93.94,24,6.06
1813,18,13,475,443,93.26,32,6.74
1814,18,14,433,420,97.0,13,3.0
1815,18,15,485,407,83.92,78,16.08
1816,18,16,420,397,94.52,23,5.48
1817,18,17,451,415,92.02,36,7.98
1818,18,18,318,306,96.23,12,3.77
1819,18,19,367,339,92.37,28,7.63
1820,18,20,315,292,92.7,23,7.3
1821,18,21,535,488,91.21,47,8.79
1822,18,22,469,443,94.46,26,5.54
1823,18,23,431,399,92.58,32,7.42
1824,18,24,446,344,77.13,102,22.87
1825,18,25,476,390,81.93,86,18.07
1826,18,26,522,496,95.02,26,4.98
1827,18,27,368,339,92.12,29,7.88
1828,18,28,444,314,70.72,130,29.28
1829,18,29,500,444,88.8,56,11.2
1830,18,30,549,432,78.69,117,21.31
1831,18,31,474,452,95.36,22,4.64
1832,18,32,423,396,93.62,27,6.38
1833,18,33,336,318,94.64,18,5.36
1834,18,34,467,436,93.36,31,6.64
1835,18,35,488,460,94.26,28,5.74
1836,18,36,478,422,88.28,56,11.72
1837,18,37,487,459,94.25,28,5.75
1838,18,38,382,363,95.03,19,4.97
1839,18,39,381,352,92.39,29,7.61
1840,18,40,474,408,86.08,66,13.92
1841,18,41,506,477,94.27,29,5.73
1842,18,42,388,358,92.27,30,7.73
1843,18,43,394,315,79.95,79,20.05
1844,18,44,415,298,71.81,117,28.19
1845,18,45,461,411,89.15,50,10.85
1846,18,46,509,405,79.57,104,20.43
1847,18,47,339,311,91.74,28,8.26
1848,18,48,320,307,95.94,13,4.06
1849,18,49,286,267,93.36,19,6.64
1850,18,50,329,296,89.97,33,10.03
1901,19,1,444,219,49.32,225,50.68
1902,19,2,632,528,83.54,104,16.46
1903,19,3,421,122,28.98,299,71.02
1904,19,4,589,229,38.88,360,61.12
1905,19,5,520,388,74.62,132,25.38
1906,19,6,546,228,41.76,318,58.24
1907,19,7,436,269,61.7,167,38.3
1908,19,8,567,200,35.27,367,64.73
1909,19,9,349,164,46.99,185,53.01
1910,19,10,603,473,78.44,130,21.56
1911,19,11,493,155,31.44,338,68.56
1912,19,12,433,140,32.33,293,67.67
1913,19,13,557,527,94.61,30,5.39
1914,19,14,525,414,78.86,111,21.14
1915,19,15,665,244,36.69,421,63.31
1916,19,16,489,184,37.63,305,62.37
1917,19,17,419,203,48.45,216,51.55
1918,19,18,464,343,73.92,121,26.08
1919,19,19,615,476,77.4,139,22.6
1920,19,20,391,336,85.93,55,14.07
1921,19,21,538,189,35.13,349,64.87
1922,19,22,534,379,70.97,155,29.03
1923,19,23,508,263,51.77,245,48.23
1924,19,24,377,140,37.14,237,62.86
1925,19,25,472,306,64.83,166,35.17
1926,19,26,476,306,64.29,170,35.71
1927,19,27,486,423,87.04,63,12.96
1928,19,28,544,506,93.01,38,6.99
1929,19,29,536,208,38.81,328,61.19
1930,19,30,494,176,35.63,318,64.37
1931,19,31,450,296,65.78,154,34.22
1932,19,32,435,224,51.49,211,48.51
1933,19,33,553,199,35.99,354,64.01
1934,19,34,430,296,68.84,134,31.16
1935,19,35,440,315,71.59,125,28.41
1936,19,36,666,585,87.84,81,12.16
1937,19,37,477,420,88.05,57,11.95
1938,19,38,428,374,87.38,54,12.62
1939,19,39,236,221,93.64,15,6.36
1940,19,40,512,384,75.0,128,25.0
1941,19,41,496,181,36.49,315,63.51
1942,19,42,393,310,78.88,83,21.12
1943,19,43,650,606,93.23,44,6.77
1944,19,44,573,209,36.47,364,63.53
1945,19,45,511,255,49.9,256,50.1
1946,19,46,469,227,48.4,242,51.6
1947,19,47,680,590,86.76,90,13.24
1948,19,48,581,549,94.49,32,5.51
1949,19,49,587,527,89.78,60,10.22
1950,19,50,413,239,57.87,174,42.13
1951,19,51,527,303,57.5,224,42.5
1952,19,52,595,236,39.66,359,60.34
1953,19,53,451,262,58.09,189,41.91
1954,19,54,427,133,31.15,294,68.85
1955,19,55,425,153,36.0,272,64.0
1956,19,56,503,395,78.53,108,21.47
1957,19,57,400,329,82.25,71,17.75
2001,20,1,461,437,94.79,24,5.21
2002,20,2,156,140,89.74,16,10.26
2003,20,3,381,359,94.23,22,5.77
2004,20,4,198,182,91.92,16,8.08
2005,20,5,497,473,95.17,24,4.83
2006,20,6,184,169,91.85,15,8.15
2007,20,7,518,488,94.21,30,5.79
2008,20,8,366,342,93.44,24,6.56
2009,20,9,613,593,96.74,20,3.26
2010,20,10,308,291,94.48,17,5.52
2011,20,11,558,526,94.27,32,5.73
2012,20,12,412,384,93.2,28,6.8
2013,20,13,421,379,90.02,42,9.98
2014,20,14,251,239,95.22,12,4.78
2015,20,15,450,400,88.89,50,11.11
2016,20,16,528,495,93.75,33,6.25
2017,20,17,286,249,87.06,37,12.94
2018,20,18,296,283,95.61,13,4.39
2019,20,19,448,419,93.53,29,6.47
2020,20,20,344,300,87.21,44,12.79
2021,20,21,359,334,93.04,25,6.96
2022,20,22,589,551,93.55,38,6.45
2023,20,23,408,381,93.38,27,6.62
2024,20,24,564,531,94.15,33,5.85
2025,20,25,292,268,91.78,24,8.22
2026,20,26,398,374,93.97,24,6.03
2027,20,27,243,225,92.59,18,7.41
2028,20,28,267,257,96.25,10,3.75
2029,20,29,485,451,92.99,34,7.01
2030,20,30,189,174,92.06,15,7.94
2031,20,31,524,495,94.47,29,5.53
2032,20,32,348,320,91.95,28,8.05
2033,20,33,269,254,94.42,15,5.58
2034,20,34,552,501,90.76,51,9.24
2035,20,35,309,288,93.2,21,6.8
2036,20,36,141,130,92.2,11,7.8
2037,20,37,131,126,96.18,5,3.82
2038,20,38,144,132,91.67,12,8.33
2039,20,39,40,36,90.0,4,10.0
2101,21,1,463,449,96.98,14,3.02
2102,21,2,323,308,95.36,15,4.64
2103,21,3,427,402,94.15,25,5.85
2104,21,4,399,383,95.99,16,4.01
2105,21,5,437,420,96.11,17,3.89
2106,21,6,351,324,92.31,27,7.69
2107,21,7,411,391,95.13,20,4.87
2108,21,8,452,424,93.81,28,6.19
2109,21,9,443,424,95.71,19,4.29
2110,21,10,346,334,96.53,12,3.47
2111,21,11,377,363,96.29,14,3.71
2112,21,12,368,343,93.21,25,6.79
2113,21,13,433,408,94.23,25,5.77
2114,21,14,450,428,95.11,22,4.89
2115,21,15,375,358,95.47,17,4.53
2116,21,16,403,380,94.29,23,5.71
2117,21,17,352,327,92.9,25,7.1
2118,21,18,476,462,97.06,14,2.94
2119,21,19,458,443,96.72,15,3.28
2120,21,20,390,375,96.15,15,3.85
2121,21,21,352,327,92.9,25,7.1
2122,21,22,377,358,94.96,19,5.04
2123,21,23,379,370,97.63,9,2.37
2124,21,24,428,410,95.79,18,4.21
2125,21,25,367,347,94.55,20,5.45
2126,21,26,442,413,93.44,29,6.56
2127,21,27,458,435,94.98,23,5.02
2128,21,28,491,474,96.54,17,3.46
2129,21,29,460,444,96.52,16,3.48
2130,21,30,365,346,94.79,19,5.21
2131,21,31,314,307,97.77,7,2.23
2132,21,32,417,406,97.36,11,2.64
2133,21,33,358,335,93.58,23,6.42
2134,21,34,397,371,93.45,26,6.55
2135,21,35,498,466,93.57,32,6.43
2136,21,36,422,404,95.73,18,4.27
2137,21,37,314,304,96.82,10,3.18
2138,21,38,421,404,95.96,17,4.04
2139,21,39,390,369,94.62,21,5.38
2140,21,40,373,355,95.17,18,4.83
2141,21,41,433,407,94.0,26,6.0
2142,21,42,463,434,93.74,29,6.26
2143,21,43,419,397,94.75,22,5.25
2144,21,44,452,416,92.04,36,7.96
2145,21,45,398,378,94.97,20,5.03
2146,21,46,437,413,94.51,24,5.49
2147,21,47,383,363,94.78,20,5.22
2148,21,48,411,391,95.13,20,4.87
2149,21,49,450,427,94.89,23,5.11
2150,21,50,302,282,93.38,20,6.62
2151,21,51,429,414,96.5,15,3.5
2152,21,52,400,377,94.25,23,5.75
2153,21,53,341,318,93.26,23,6.74
2154,21,54,350,329,94.0,21,6.0
2201,22,1,237,223,94.09,14,5.91
2202,22,2,540,392,72.59,148,27.41
2203,22,3,676,602,89.05,74,10.95
2204,22,4,358,331,92.46,27,7.54
2205,22,5,422,380,90.05,42,9.95
2206,22,6,420,380,90.48,40,9.52
2207,22,7,346,322,93.06,24,6.94
2208,22,8,627,507,80.86,120,19.14
2209,22,9,352,331,94.03,21,5.97
2210,22,10,592,528,89.19,64,10.81
2211,22,11,355,318,89.58,37,10.42
2212,22,12,370,286,77.3,84,22.7
2213,22,13,466,423,90.77,43,9.23
2214,22,14,356,325,91.29,31,8.71
2215,22,15,368,335,91.03,33,8.97
2216,22,16,358,327,91.34,31,8.66
2217,22,17,573,503,87.78,70,12.22
2218,22,18,374,334,89.3,40,10.7
2219,22,19,206,191,92.72,15,7.28
2220,22,20,441,398,90.25,43,9.75
2221,22,21,410,393,95.85,17,4.15
2222,22,22,423,381,90.07,42,9.93
2223,22,23,475,451,94.95,24,5.05
2224,22,24,512,460,89.84,52,10.16
2225,22,25,424,394,92.92,30,7.08
2301,23,1,412,208,50.49,204,49.51
2302,23,2,463,266,57.45,197,42.55
2303,23,3,418,213,50.96,205,49.04
2304,23,4,483,298,61.7,185,38.3
2305,23,5,454,394,86.78,60,13.22
2306,23,6,462,366,79.22,96,20.78
2307,23,7,412,347,84.22,65,15.78
2308,23,8,523,379,72.47,144,27.53
2309,23,9,413,367,88.86,46,11.14
2310,23,10,490,400,81.63,90,18.37
2311,23,11,500,443,88.6,57,11.4
2312,23,12,470,203,43.19,267,56.81
2313,23,13,422,374,88.63,48,11.37
2314,23,14,411,231,56.2,180,43.8
2315,23,15,395,348,88.1,47,11.9
2316,23,16,422,222,52.61,200,47.39
2317,23,17,342,297,86.84,45,13.16
2318,23,18,407,231,56.76,176,43.24
2319,23,19,377,328,87.0,49,13.0
2320,23,20,310,262,84.52,48,15.48
2321,23,21,418,208,49.76,210,50.24
2322,23,22,448,271,60.49,177,39.51
2323,23,23,411,252,61.31,159,38.69
2324,23,24,393,335,85.24,58,14.76
2325,23,25,386,309,80.05,77,19.95
2326,23,26,446,348,78.03,98,21.97
2327,23,27,403,202,50.12,201,49.88
2328,23,28,489,280,57.26,209,42.74
2329,23,29,396,250,63.13,146,36.87
2330,23,30,506,413,81.62,93,18.38
2331,23,31,393,335,85.24,58,14.76
2332,23,32,408,356,87.25,52,12.75
2333,23,33,494,423,85.63,71,14.37
2334,23,34,482,414,85.89,68,14.11
2335,23,35,337,182,54.01,155,45.99
2336,23,36,441,221,50.11,220,49.89
2337,23,37,485,239,49.28,246,50.72
2338,23,38,402,255,63.43,147,36.57
2339,23,39,475,424,89.26,51,10.74
2401,24,1,305,289,94.75,16,5.25
2402,24,2,354,335,94.63,19,5.37
2403,24,3,428,395,92.29,33,7.71
2404,24,4,293,273,93.17,20,6.83
2405,24,5,201,193,96.02,8,3.98
2406,24,6,374,353,94.39,21,5.61
2407,24,7,265,255,96.23,10,3.77
2408,24,8,170,157,92.35,13,7.65
2409,24,9,342,319,93.27,23,6.73
2410,24,10,171,161,94.15,10,5.85
2411,24,11,404,375,92.82,29,7.18
2412,24,12,229,217,94.76,12,5.24
2413,24,13,218,198,90.83,20,9.17
2414,24,14,318,294,92.45,24,7.55
2415,24,15,192,181,94.27,11,5.73
2416,24,16,1051,865,82.3,186,17.7
2417,24,17,266,244,91.73,22,8.27
2418,24,18,356,334,93.82,22,6.18
2419,24,19,419,394,94.03,25,5.97
2420,24,20,304,281,92.43,23,7.57
2421,24,21,195,176,90.26,19,9.74
2422,24,22,442,410,92.76,32,7.24
2423,24,23,315,292,92.7,23,7.3
2424,24,24,408,382,93.63,26,6.37
2425,24,25,290,273,94.14,17,5.86
2426,24,26,513,485,94.54,28,5.46
2427,24,27,367,347,94.55,20,5.45
2428,24,28,241,224,92.95,17,7.05
2429,24,29,251,240,95.62,11,4.38
2430,24,30,220,207,94.09,13,5.91
2431,24,31,382,350,91.62,32,8.38
2432,24,32,190,176,92.63,14,7.37
2433,24,33,228,214,93.86,14,6.14
2434,24,34,346,320,92.49,26,7.51
2435,24,35,340,314,92.35,26,7.65
2436,24,36,400,366,91.5,34,8.5
2437,24,37,199,191,95.98,8,4.02
2438,24,38,285,257,90.18,28,9.82
2439,24,39,361,328,90.86,33,9.14
2440,24,40,412,387,93.93,25,6.07
2441,24,41,248,231,93.15,17,6.85
2501,25,1,435,386,88.74,49,11.26
2502,25,2,665,617,92.78,48,7.22
2503,25,3,1013,765,75.52,248,24.48
2504,25,4,428,370,86.45,58,13.55
2505,25,5,587,519,88.42,68,11.58
2506,25,6,193,136,70.47,57,29.53
2507,25,7,579,526,90.85,53,9.15
2508,25,8,643,607,94.4,36,5.6
2509,25,9,550,505,91.82,45,8.18
2510,25,10,819,591,72.16,228,27.84
2511,25,11,571,521,91.24,50,8.76
2512,25,12,539,482,89.42,57,10.58
2513,25,13,655,603,92.06,52,7.94
2514,25,14,415,322,77.59,93,22.41
2515,25,15,467,409,87.58,58,12.42
2516,25,16,1021,671,65.72,350,34.28
2517,25,17,600,528,88.0,72,12.0
2518,25,18,316,229,72.47,87,27.53
2519,25,19,586,547,93.34,39,6.66
2520,25,20,320,293,91.56,27,8.44
2521,25,21,1096,895,81.66,201,18.34
2522,25,22,560,526,93.93,34,6.07
2523,25,23,632,577,91.3,55,8.7
2524,25,24,565,519,91.86,46,8.14
2525,25,25,507,367,72.39,140,27.61
2526,25,26,555,506,91.17,49,8.83
2527,25,27,770,604,78.44,166,21.56
2528,25,28,579,526,90.85,53,9.15
2529,25,29,441,392,88.89,49,11.11
2530,25,30,538,484,89.96,54,10.04
2531,25,31,1152,799,69.36,353,30.64
2532,25,32,478,389,81.38,89,18.62
2601,26,1,466,413,88.63,53,11.37
2602,26,2,373,328,87.94,45,12.06
2603,26,3,536,450,83.96,86,16.04
2604,26,4,318,278,87.42,40,12.58
2605,26,5,386,357,92.49,29,7.51
2606,26,6,378,348,92.06,30,7.94
2607,26,7,413,378,91.53,35,8.47
2608,26,8,272,239,87.87,33,12.13
2609,26,9,380,338,88.95,42,11.05
2610,26,10,424,370,87.26,54,12.74
2611,26,11,415,355,85.54,60,14.46
2612,26,12,451,407,90.24,44,9.76
2613,26,13,250,223,89.2,27,10.8
2614,26,14,360,325,90.28,35,9.72
2615,26,15,292,252,86.3,40,13.7
2616,26,16,234,203,86.75,31,13.25
2617,26,17,389,276,70.95,113,29.05
2618,26,18,322,279,86.65,43,13.35
2619,26,19,279,257,92.11,22,7.89
2620,26,20,402,349,86.82,53,13.18
2621,26,21,503,453,90.06,50,9.94
2622,26,22,256,216,84.38,40,15.63
2623,26,23,321,286,89.1,35,10.9
2624,26,24,367,332,90.46,35,9.54
2625,26,25,350,316,90.29,34,9.71
2626,26,26,308,278,90.26,30,9.74
2627,26,27,490,427,87.14,63,12.86
2628,26,28,553,460,83.18,93,16.82
2629,26,29,240,204,85.0,36,15.0
2630,26,30,356,329,92.42,27,7.58
2631,26,31,212,178,83.96,34,16.04
2632,26,32,524,428,81.68,96,18.32
2633,26,33,494,443,89.68,51,10.32
2634,26,34,468,424,90.6,44,9.4
2635,26,35,377,343,90.98,34,9.02
2636,26,36,440,367,83.41,73,16.59
2637,26,37,453,411,90.73,42,9.27
2638,26,38,229,196,85.59,33,14.41
2639,26,39,502,428,85.26,74,14.74
2640,26,40,292,256,87.67,36,12.33
2641,26,41,476,444,93.28,32,6.72
2642,26,42,344,308,89.53,36,10.47
2643,26,43,266,245,92.11,21,7.89
2644,26,44,238,215,90.34,23,9.66
2645,26,45,219,193,88.13,26,11.87
2646,26,46,329,234,71.12,95,28.88
2647,26,47,315,277,87.94,38,12.06
2648,26,48,453,410,90.51,43,9.49
2649,26,49,275,249,90.55,26,9.45
2701,27,1,1216,915,75.25,301,24.75
2702,27,2,553,434,78.48,119,21.52
2703,27,3,243,230,94.65,13,5.35
2704,27,4,263,233,88.59,30,11.41
2705,27,5,383,343,89.56,40,10.44
2706,27,6,608,460,75.66,148,24.34
2707,27,7,728,634,87.09,94,12.91
2708,27,8,378,343,90.74,35,9.26
2709,27,9,265,172,64.91,93,35.09
2710,27,10,378,334,88.36,44,11.64
2711,27,11,664,475,71.54,189,28.46
2712,27,12,445,329,73.93,116,26.07
2713,27,13,666,590,88.59,76,11.41
2714,27,14,229,211,92.14,18,7.86
2715,27,15,235,218,92.77,17,7.23
2716,27,16,629,470,74.72,159,25.28
2717,27,17,489,425,86.91,64,13.09
2718,27,18,323,287,88.85,36,11.15
2719,27,19,234,213,91.03,21,8.97
2720,27,20,343,319,93.0,24,7.0
2721,27,21,507,363,71.6,144,28.4
2722,27,22,224,209,93.3,15,6.7
2723,27,23,305,283,92.79,22,7.21
2724,27,24,310,285,91.94,25,8.06
2725,27,25,462,409,88.53,53,11.47
2726,27,26,317,291,91.8,26,8.2
2727,27,27,626,560,89.46,66,10.54
2728,27,28,722,500,69.25,222,30.75
2729,27,29,303,270,89.11,33,10.89
2730,27,30,218,197,90.37,21,9.63
2731,27,31,341,312,91.5,29,8.5
2732,27,32,433,383,88.45,50,11.55
2733,27,33,714,562,78.71,152,21.29
2734,27,34,310,290,93.55,20,6.45
2735,27,35,663,507,76.47,156,23.53
2736,27,36,340,320,94.12,20,5.88
2737,27,37,534,408,76.4,126,23.6
2738,27,38,658,528,80.24,130,19.76
2739,27,39,326,296,90.8,30,9.2
2740,27,40,728,547,75.14,181,24.86
2741,27,41,383,354,92.43,29,7.57
2742,27,42,361,282,78.12,79,21.88
2743,27,43,369,343,92.95,26,7.05
2744,27,44,316,293,92.72,23,7.28
2745,27,45,1581,1175,74.32,406,25.68
2746,27,46,463,309,66.74,154,33.26
2747,27,47,321,282,87.85,39,12.15
2748,27,48,984,773,78.56,211,21.44
2749,27,49,323,304,94.12,19,5.88
2750,27,50,425,377,88.71,48,11.29
2801,28,1,277,251,90.61,26,9.39
2802,28,2,332,308,92.77,24,7.23
2803,28,3,278,264,94.96,14,5.04
2804,28,4,401,325,81.05,76,18.95
2805,28,5,247,228,92.31,19,7.69
2806,28,6,221,183,82.81,38,17.19
2807,28,7,366,345,94.26,21,5.74
2808,28,8,628,482,76.75,146,23.25
2809,28,9,359,340,94.71,19,5.29
2810,28,10,531,436,82.11,95,17.89
2811,28,11,884,779,88.12,105,11.88
2812,28,12,334,323,96.71,11,3.29
2813,28,13,417,395,94.72,22,5.28
2814,28,14,344,326,94.77,18,5.23
2815,28,15,70,67,95.71,3,4.29
2816,28,16,228,212,92.98,16,7.02
2817,28,17,304,290,95.39,14,4.61
2818,28,18,306,283,92.48,23,7.52
2819,28,19,332,283,85.24,49,14.76
2820,28,20,293,269,91.81,24,8.19
2821,28,21,295,274,92.88,21,7.12
2822,28,22,332,309,93.07,23,6.93
2823,28,23,461,429,93.06,32,6.94
2824,28,24,324,290,89.51,34,10.49
2825,28,25,536,504,94.03,32,5.97
2826,28,26,351,333,94.87,18,5.13
2827,28,27,435,300,68.97,135,31.03
2828,28,28,537,420,78.21,117,21.79
2829,28,29,190,176,92.63,14,7.37
2830,28,30,54,52,96.3,2,3.7
2831,28,31,392,370,94.39,22,5.61
2832,28,32,354,333,94.07,21,5.93
2833,28,33,390,365,93.59,25,6.41
2834,28,34,649,598,92.14,51,7.86
2835,28,35,410,383,93.41,27,6.59
2836,28,36,188,181,96.28,7,3.72
2837,28,37,400,378,94.5,22,5.5
2838,28,38,141,131,92.91,10,7.09
2839,28,39,290,270,93.1,20,6.9
2840,28,40,461,438,95.01,23,4.99
2841,28,41,246,235,95.53,11,4.47
2842,28,42,358,332,92.74,26,7.26
2843,28,43,450,428,95.11,22,4.89
2844,28,44,268,256,95.52,12,4.48
2845,28,45,594,456,76.77,138,23.23
2846,28,46,757,631,83.36,126,16.64
2901,29,1,620,518,83.55,102,16.45
2902,29,2,560,526,93.93,34,6.07
2903,29,3,476,449,94.33,27,5.67
2904,29,4,521,482,92.51,39,7.49
2905,29,5,336,316,94.05,20,5.95
2906,29,6,327,314,96.02,13,3.98
2907,29,7,496,441,88.91,55,11.09
2908,29,8,404,373,92.33,31,7.67
2909,29,9,505,395,78.22,110,21.78
2910,29,10,612,496,81.05,116,18.95
2911,29,11,241,224,92.95,17,7.05
2912,29,12,549,512,93.26,37,6.74
2913,29,13,458,425,92.79,33,7.21
2914,29,14,384,359,93.49,25,6.51
2915,29,15,502,481,95.82,21,4.18
2916,29,16,417,401,96.16,16,3.84
2917,29,17,429,411,95.8,18,4.2
2918,29,18,423,395,93.38,28,6.62
2919,29,19,448,422,94.2,26,5.8
2920,29,20,473,442,93.45,31,6.55
2921,29,21,592,553,93.41,39,6.59
2922,29,22,345,313,90.72,32,9.28
2923,29,23,578,408,70.59,170,29.41
2924,29,24,427,398,93.21,29,6.79
2925,29,25,505,480,95.05,25,4.95
2926,29,26,425,398,93.65,27,6.35
2927,29,27,396,378,95.45,18,4.55
2928,29,28,547,521,95.25,26,4.75
2929,29,29,616,404,65.58,212,34.42
2930,29,30,652,559,85.74,93,14.26
2931,29,31,573,335,58.46,238,41.54
2932,29,32,561,345,61.5,216,38.5
2933,29,33,320,299,93.44,21,6.56
2934,29,34,330,292,88.48,38,11.52
2935,29,35,344,326,94.77,18,5.23
2936,29,36,377,356,94.43,21,5.57
2937,29,37,417,386,92.57,31,7.43
2938,29,38,594,443,74.58,151,25.42
2939,29,39,556,386,69.42,170,30.58
2940,29,40,500,480,96.0,20,4.0
2941,29,41,383,358,93.47,25,6.53
2942,29,42,487,468,96.1,19,3.9
2943,29,43,582,521,89.52,61,10.48
2944,29,44,573,530,92.5,43,7.5
3001,30,1,598,489,81.77,109,18.23
3002,30,2,560,428,76.43,132,23.57
3003,30,3,432,363,84.03,69,15.97
3004,30,4,528,385,72.92,143,27.08
3005,30,5,411,344,83.7,67,16.3
3006,30,6,433,367,84.76,66,15.24
3007,30,7,569,467,82.07,102,17.93
3008,30,8,629,526,83.62,103,16.38
3009,30,9,482,369,76.56,113,23.44
3010,30,10,568,467,82.22,101,17.78
3011,30,11,524,457,87.21,67,12.79
3012,30,12,491,398,81.06,93,18.94
3013,30,13,529,405,76.56,124,23.44
3014,30,14,418,351,83.97,67,16.03
3015,30,15,471,382,81.1,89,18.9
3016,30,16,314,242,77.07,72,22.93
3017,30,17,555,427,76.94,128,23.06
3018,30,18,655,594,90.69,61,9.31
3019,30,19,541,463,85.58,78,14.42
3020,30,20,593,466,78.58,127,21.42
3021,30,21,409,282,68.95,127,31.05
3022,30,22,764,665,87.04,99,12.96
3023,30,23,666,563,84.53,103,15.47
3024,30,24,784,675,86.1,109,13.9
3025,30,25,785,677,86.24,108,13.76
3026,30,26,346,281,81.21,65,18.79
3027,30,27,401,314,78.3,87,21.7
3028,30,28,535,460,85.98,75,14.02
3029,30,29,372,321,86.29,51,13.71
3030,30,30,229,199,86.9,30,13.1
3031,30,31,354,279,78.81,75,21.19
3032,30,32,444,377,84.91,67,15.09
3101,31,1,351,307,87.46,44,12.54
3102,31,2,314,279,88.85,35,11.15
3103,31,3,352,276,78.41,76,21.59
3104,31,4,450,404,89.78,46,10.22
3105,31,5,374,314,83.96,60,16.04
3106,31,6,267,226,84.64,41,15.36
3107,31,7,523,471,90.06,52,9.94
3108,31,8,327,275,84.1,52,15.9
3109,31,9,387,328,84.75,59,15.25
3110,31,10,423,372,87.94,51,12.06
3111,31,11,305,252,82.62,53,17.38
3112,31,12,322,240,74.53,82,25.47
3113,31,13,401,342,85.29,59,14.71
3114,31,14,348,288,82.76,60,17.24
3115,31,15,376,299,79.52,77,20.48
3116,31,16,429,385,89.74,44,10.26
3117,31,17,347,279,80.4,68,19.6
3118,31,18,344,303,88.08,41,11.92
3119,31,19,335,274,81.79,61,18.21
3120,31,20,322,259,80.43,63,19.57
3121,31,21,327,274,83.79,53,16.21
3122,31,22,321,285,88.79,36,11.21
3123,31,23,395,329,83.29,66,16.71
3124,31,24,374,326,87.17,48,12.83
3125,31,25,362,287,79.28,75,20.72
3126,31,26,366,304,83.06,62,16.94
3127,31,27,425,345,81.18,80,18.82
3128,31,28,325,267,82.15,58,17.85
3129,31,29,352,298,84.66,54,15.34
3130,31,30,293,257,87.71,36,12.29
3131,31,31,316,238,75.32,78,24.68
3132,31,32,298,249,83.56,49,16.44
3133,31,33,346,283,81.79,63,18.21
3134,31,34,377,310,82.23,67,17.77
3135,31,35,441,376,85.26,65,14.74
3136,31,36,385,323,83.9,62,16.1
3137,31,37,355,299,84.23,56,15.77
3138,31,38,335,293,87.46,42,12.54
3139,31,39,402,359,89.3,43,10.7
3140,31,40,409,355,86.8,54,13.2
3141,31,41,335,287,85.67,48,14.33
3201,32,1,839,681,81.17,158,18.83
3202,32,2,750,581,77.47,169,22.53
3203,32,3,691,602,87.12,89,12.88
3204,32,4,619,500,80.78,119,19.22
3205,32,5,705,590,83.69,115,16.31
3206,32,6,777,653,84.04,124,15.96
3207,32,7,764,607,79.45,157,20.55
3208,32,8,863,635,73.58,228,26.42
3209,32,9,692,557,80.49,135,19.51
3210,32,10,782,581,74.3,201,25.7
3211,32,11,576,519,90.1,57,9.9
3212,32,12,452,420,92.92,32,7.08
3213,32,13,788,569,72.21,219,27.79
3214,32,14,699,626,89.56,73,10.44
3215,32,15,640,496,77.5,144,22.5
3216,32,16,652,537,82.36,115,17.64
3217,32,17,626,561,89.62,65,10.38
3218,32,18,674,467,69.29,207,30.71
3219,32,19,648,521,80.4,127,19.6
3220,32,20,603,553,91.71,50,8.29
3221,32,21,672,536,79.76,136,20.24
3222,32,22,787,713,90.6,74,9.4
3223,32,23,710,544,76.62,166,23.38
3224,32,24,600,403,67.17,197,32.83
3225,32,25,665,533,80.15,132,19.85
3226,32,26,671,602,89.72,69,10.28
3227,32,27,736,515,69.97,221,30.03
3228,32,28,654,592,90.52,62,9.48
3229,32,29,709,602,84.91,107,15.09
3230,32,30,709,509,71.79,200,28.21
3231,32,31,737,551,74.76,186,25.24
3232,32,32,779,630,80.87,149,19.13
3233,32,33,657,501,76.26,156,23.74
3234,32,34,751,625,83.22,126,16.78
3235,32,35,664,509,76.66,155,23.34
3236,32,36,727,578,79.5,149,20.5
3237,32,37,790,630,79.75,160,20.25
3238,32,38,695,522,75.11,173,24.89
3239,32,39,783,535,68.33,248,31.67
3240,32,40,693,532,76.77,161,23.23
3241,32,41,736,548,74.46,188,25.54
3242,32,42,661,495,74.89,166,25.11
3243,32,43,577,509,88.21,68,11.79
3301,33,1,692,614,88.73,78,11.27
3302,33,2,875,723,82.63,152,17.37
3303,33,3,914,801,87.64,113,12.36
3304,33,4,897,764,85.17,133,14.83
3305,33,5,668,562,84.13,106,15.87
3306,33,6,601,527,87.69,74,12.31
3307,33,7,688,601,87.35,87,12.65
3308,33,8,822,706,85.89,116,14.11
3309,33,9,746,622,83.38,124,16.62
3310,33,10,589,485,82.34,104,17.66
3311,33,11,684,577,84.36,107,15.64
3312,33,12,697,598,85.8,99,14.2
3313,33,13,646,560,86.69,86,13.31
3314,33,14,330,287,86.97,43,13.03
3315,33,15,711,630,88.61,81,11.39
3316,33,16,955,811,84.92,144,15.08
3317,33,17,716,603,84.22,113,15.78
3318,33,18,976,849,86.99,127,13.01
3319,33,19,831,690,83.03,141,16.97
3320,33,20,838,754,89.98,84,10.02
3321,33,21,708,622,87.85,86,12.15
3322,33,22,646,527,81.58,119,18.42
3323,33,23,738,630,85.37,108,14.63
3324,33,24,807,686,85.01,121,14.99
3325,33,25,811,683,84.22,128,15.78
3326,33,26,519,468,90.17,51,9.83
3327,33,27,800,676,84.5,124,15.5
3328,33,28,607,551,90.77,56,9.23
3401,34,1,452,439,97.12,13,2.88
3402,34,2,370,349,94.32,21,5.68
3403,34,3,421,403,95.72,18,4.28
3404,34,4,322,306,95.03,16,4.97
3405,34,5,375,359,95.73,16,4.27
3406,34,6,477,452,94.76,25,5.24
3407,34,7,455,432,94.95,23,5.05
3408,34,8,361,346,95.84,15,4.16
3409,34,9,297,276,92.93,21,7.07
3410,34,10,432,414,95.83,18,4.17
3411,34,11,367,342,93.19,25,6.81
3412,34,12,452,427,94.47,25,5.53
3413,34,13,424,402,94.81,22,5.19
3414,34,14,336,311,92.56,25,7.44
3415,34,15,400,373,93.25,27,6.75
3416,34,16,370,356,96.22,14,3.78
3417,34,17,516,494,95.74,22,4.26
3418,34,18,288,272,94.44,16,5.56
3419,34,19,464,440,94.83,24,5.17
3420,34,20,460,437,95.0,23,5.0
3421,34,21,471,451,95.75,20,4.25
3422,34,22,424,408,96.23,16,3.77
3423,34,23,347,335,96.54,12,3.46
3424,34,24,363,345,95.04,18,4.96
3425,34,25,632,607,96.04,25,3.96
3426,34,26,481,463,96.26,18,3.74
3427,34,27,345,329,95.36,16,4.64
3428,34,28,271,251,92.62,20,7.38
3429,34,29,349,338,96.85,11,3.15
3430,34,30,403,383,95.04,20,4.96
3431,34,31,340,319,93.82,21,6.18
3432,34,32,416,394,94.71,22,5.29
3433,34,33,346,323,93.35,23,6.65
3434,34,34,485,466,96.08,19,3.92
3435,34,35,516,488,94.57,28,5.43
3436,34,36,369,350,94.85,19,5.15
3437,34,37,240,224,93.33,16,6.67
3438,34,38,210,195,92.86,15,7.14
3439,34,39,311,291,93.57,20,6.43
3440,34,40,460,447,97.17,13,2.83
3441,34,41,252,239,94.84,13,5.16
3442,34,42,399,383,95.99,16,4.01
3443,34,43,379,362,95.51,17,4.49
3444,34,44,389,380,97.69,9,2.31
3445,34,45,424,412,97.17,12,2.83
3446,34,46,286,276,96.5,10,3.5
3447,34,47,389,374,96.14,15,3.86
3448,34,48,429,411,95.8,18,4.2
3449,34,49,393,377,95.93,16,4.07
3450,34,50,337,319,94.66,18,5.34
3451,34,51,449,423,94.21,26,5.79
3452,34,52,320,301,94.06,19,5.94
3453,34,53,284,263,92.61,21,7.39
3501,35,1,608,543,89.31,65,10.69
3502,35,2,588,520,88.44,68,11.56
3503,35,3,528,468,88.64,60,11.36
3504,35,4,586,483,82.42,103,17.58
3505,35,5,500,455,91.0,45,9.0
3506,35,6,602,543,90.2,59,9.8
3507,35,7,593,547,92.24,46,7.76
3508,35,8,580,530,91.38,50,8.62
3509,35,9,527,436,82.73,91,17.27
3510,35,10,664,620,93.37,44,6.63
3511,35,11,661,586,88.65,75,11.35
3512,35,12,431,369,85.61,62,14.39
3513,35,13,415,378,91.08,37,8.92
3514,35,14,459,407,88.67,52,11.33
3515,35,15,689,624,90.57,65,9.43
3516,35,16,342,304,88.89,38,11.11
3517,35,17,589,548,93.04,41,6.96
3518,35,18,387,338,87.34,49,12.66
3519,35,19,371,319,85.98,52,14.02
3520,35,20,583,508,87.14,75,12.86
3521,35,21,582,542,93.13,40,6.87
3522,35,22,681,596,87.52,85,12.48
3523,35,23,599,505,84.31,94,15.69
3524,35,24,521,463,88.87,58,11.13
3525,35,25,586,520,88.74,66,11.26
3526,35,26,497,425,85.51,72,14.49
3527,35,27,541,467,86.32,74,13.68
3528,35,28,560,504,90.0,56,10.0
3529,35,29,565,473,83.72,92,16.28
3530,35,30,557,475,85.28,82,14.72
3531,35,31,615,507,82.44,108,17.56
3601,36,1,493,389,78.9,104,21.1
3602,36,2,475,417,87.79,58,12.21
3603,36,3,432,347,80.32,85,19.68
3604,36,4,529,454,85.82,75,14.18
3605,36,5,427,369,86.42,58,13.58
3606,36,6,459,373,81.26,86,18.74
3607,36,7,560,357,63.75,203,36.25
3608,36,8,413,357,86.44,56,13.56
3609,36,9,463,385,83.15,78,16.85
3610,36,10,645,485,75.19,160,24.81
3611,36,11,353,303,85.84,50,14.16
3612,36,12,332,288,86.75,44,13.25
3613,36,13,367,326,88.83,41,11.17
3614,36,14,537,396,73.74,141,26.26
3615,36,15,518,363,70.08,155,29.92
3616,36,16,509,381,74.85,128,25.15
3617,36,17,617,467,75.69,150,24.31
3618,36,18,537,388,72.25,149,27.75
3619,36,19,622,501,80.55,121,19.45
3620,36,20,570,413,72.46,157,27.54
3621,36,21,444,370,83.33,74,16.67
3622,36,22,445,390,87.64,55,12.36
3623,36,23,451,385,85.37,66,14.63
3624,36,24,591,437,73.94,154,26.06
3625,36,25,508,442,87.01,66,12.99
3626,36,26,508,315,62.01,193,37.99
3627,36,27,442,343,77.6,99,22.4
3628,36,28,514,346,67.32,168,32.68
3629,36,29,543,384,70.72,159,29.28
3630,36,30,480,359,74.79,121,25.21
3701,37,1,338,311,92.01,27,7.99
3702,37,2,356,330,92.7,26,7.3
3703,37,3,280,256,91.43,24,8.57
3704,37,4,323,294,91.02,29,8.98
3705,37,5,399,371,92.98,28,7.02
3706,37,6,409,388,94.87,21,5.13
3707,37,7,321,292,90.97,29,9.03
3708,37,8,297,278,93.6,19,6.4
3709,37,9,389,362,93.06,27,6.94
3710,37,10,497,459,92.35,38,7.65
3711,37,11,258,239,92.64,19,7.36
3712,37,12,384,360,93.75,24,6.25
3713,37,13,289,269,93.08,20,6.92
3714,37,14,425,395,92.94,30,7.06
3715,37,15,422,397,94.08,25,5.92
3716,37,16,461,426,92.41,35,7.59
3717,37,17,296,271,91.55,25,8.45
3718,37,18,349,313,89.68,36,10.32
3719,37,19,304,288,94.74,16,5.26
3720,37,20,357,340,95.24,17,4.76
3721,37,21,352,326,92.61,26,7.39
3722,37,22,367,331,90.19,36,9.81
3723,37,23,378,357,94.44,21,5.56
3724,37,24,395,375,94.94,20,5.06
3725,37,25,346,319,92.2,27,7.8
3726,37,26,531,484,91.15,47,8.85
3727,37,27,362,341,94.2,21,5.8
3728,37,28,364,333,91.48,31,8.52
3729,37,29,372,341,91.67,31,8.33
3730,37,30,382,358,93.72,24,6.28
3731,37,31,455,412,90.55,43,9.45
3732,37,32,345,316,91.59,29,8.41
3733,37,33,416,387,93.03,29,6.97
3734,37,34,336,315,93.75,21,6.25
3735,37,35,382,362,94.76,20,5.24
3736,37,36,387,364,94.06,23,5.94
3737,37,37,431,405,93.97,26,6.03
3738,37,38,422,394,93.36,28,6.64
3739,37,39,359,333,92.76,26,7.24
3740,37,40,402,376,93.53,26,6.47
3741,37,41,394,363,92.13,31,7.87
3801,38,1,489,370,75.66,119,24.34
3802,38,2,549,213,38.8,336,61.2
3803,38,3,563,324,57.55,239,42.45
3804,38,4,518,283,54.63,235,45.37
3805,38,5,552,333,60.33,219,39.67
3806,38,6,560,304,54.29,256,45.71
3807,38,7,523,281,53.73,242,46.27
3808,38,8,525,305,58.1,220,41.9
3809,38,9,621,330,53.14,291,46.86
3810,38,10,479,289,60.33,190,39.67
3811,38,11,470,313,66.6,157,33.4
3812,38,12,541,228,42.14,313,57.86
3813,38,13,619,335,54.12,284,45.88
3814,38,14,560,362,64.64,198,35.36
3815,38,15,516,359,69.57,157,30.43
3816,38,16,514,309,60.12,205,39.88
3817,38,17,643,293,45.57,350,54.43
3818,38,18,575,353,61.39,222,38.61
3819,38,19,615,361,58.7,254,41.3
3820,38,20,572,272,47.55,300,52.45
3821,38,21,528,361,68.37,167,31.63
3822,38,22,484,347,71.69,137,28.31
3823,38,23,549,378,68.85,171,31.15
3824,38,24,575,305,53.04,270,46.96
3825,38,25,509,308,60.51,201,39.49
3826,38,26,572,347,60.66,225,39.34
3827,38,27,560,314,56.07,246,43.93
3828,38,28,669,323,48.28,346,51.72
3829,38,29,579,360,62.18,219,37.82
3830,38,30,554,299,53.97,255,46.03
3831,38,31,516,379,73.45,137,26.55
3832,38,32,517,348,67.31,169,32.69
3833,38,33,546,385,70.51,161,29.49
3834,38,34,502,373,74.3,129,25.7
3835,38,35,516,397,76.94,119,23.06
3836,38,36,518,355,68.53,163,31.47
3837,38,37,528,360,68.18,168,31.82
3838,38,38,530,311,58.68,219,41.32
3839,38,39,564,404,71.63,160,28.37
3840,38,40,527,369,70.02,158,29.98
3841,38,41,478,380,79.5,98,20.5
3901,39,1,536,320,59.7,216,40.3
3902,39,2,426,271,63.62,155,36.38
3903,39,3,594,476,80.13,118,19.87
3904,39,4,526,317,60.27,209,39.73
3905,39,5,559,403,72.09,156,27.91
3906,39,6,551,433,78.58,118,21.42
3907,39,7,486,375,77.16,111,22.84
3908,39,8,571,434,76.01,137,23.99
3909,39,9,498,368,73.9,130,26.1
3910,39,10,258,226,87.6,32,12.4
3911,39,11,518,367,70.85,151,29.15
3912,39,12,713,599,84.01,114,15.99
3913,39,13,480,351,73.13,129,26.88
3914,39,14,528,401,75.95,127,24.05
3915,39,15,645,354,54.88,291,45.12
3916,39,16,519,394,75.92,125,24.08
3917,39,17,554,402,72.56,152,27.44
3918,39,18,534,401,75.09,133,24.91
3919,39,19,520,390,75.0,130,25.0
3920,39,20,685,383,55.91,302,44.09
3921,39,21,546,305,55.86,241,44.14
3922,39,22,532,423,79.51,109,20.49
3923,39,23,547,329,60.15,218,39.85
3924,39,24,675,385,57.04,290,42.96
3925,39,25,464,374,80.6,90,19.4
3926,39,26,511,290,56.75,221,43.25
3927,39,27,80,54,67.5,26,32.5
3928,39,28,654,553,84.56,101,15.44
3929,39,29,296,249,84.12,47,15.88
3930,39,30,624,529,84.78,95,15.22
3931,39,31,474,390,82.28,84,17.72
3932,39,32,491,282,57.43,209,42.57
3933,39,33,553,424,76.67,129,23.33
3934,39,34,644,515,79.97,129,20.03
3935,39,35,543,427,78.64,116,21.36
3936,39,36,134,99,73.88,35,26.12
3937,39,37,509,333,65.42,176,34.58
3938,39,38,290,210,72.41,80,27.59
3939,39,39,334,239,71.56,95,28.44
3940,39,40,556,335,60.25,221,39.75
3941,39,41,564,352,62.41,212,37.59
3942,39,42,564,299,53.01,265,46.99
3943,39,43,551,309,56.08,242,43.92
3944,39,44,437,259,59.27,178,40.73
3945,39,45,485,292,60.21,193,39.79
4001,40,1,547,399,72.94,148,27.06
4002,40,2,614,503,81.92,111,18.08
4003,40,3,744,654,87.9,90,12.1
4004,40,4,371,299,80.59,72,19.41
4005,40,5,634,535,84.38,99,15.62
4006,40,6,699,618,88.41,81,11.59
4007,40,7,580,506,87.24,74,12.76
4008,40,8,790,693,87.72,97,12.28
4009,40,9,485,391,80.62,94,19.38
4010,40,10,669,541,80.87,128,19.13
4011,40,11,606,523,86.3,83,13.7
4012,40,12,528,456,86.36,72,13.64
4013,40,13,862,784,90.95,78,9.05
4014,40,14,577,416,72.1,161,27.9
4015,40,15,598,467,78.09,131,21.91
4016,40,16,786,697,88.68,89,11.32
4017,40,17,493,388,78.7,105,21.3
4018,40,18,489,421,86.09,68,13.91
4019,40,19,723,579,80.08,144,19.92
4020,40,20,631,509,80.67,122,19.33
4021,40,21,658,581,88.3,77,11.7
4022,40,22,721,625,86.69,96,13.31
4023,40,23,701,629,89.73,72,10.27
4024,40,24,560,407,72.68,153,27.32
4025,40,25,697,620,88.95,77,11.05
4026,40,26,639,571,89.36,68,10.64
4027,40,27,762,655,85.96,107,14.04
4028,40,28,624,553,88.62,71,11.38
4029,40,29,604,469,77.65,135,22.35
4030,40,30,505,373,73.86,132,26.14
4031,40,31,669,601,89.84,68,10.16
4032,40,32,649,569,87.67,80,12.33
4033,40,33,573,515,89.88,58,10.12
4034,40,34,554,405,73.1,149,26.9
4035,40,35,426,322,75.59,104,24.41
4036,40,36,538,460,85.5,78,14.5
4037,40,37,623,528,84.75,95,15.25
4038,40,38,740,630,85.14,110,14.86
4039,40,39,256,193,75.39,63,24.61
4101,41,1,548,230,41.97,318,58.03
4102,41,2,587,252,42.93,335,57.07
4103,41,3,557,306,54.94,251,45.06
4104,41,4,537,275,51.21,262,48.79
4105,41,5,681,362,53.16,319,46.84
4106,41,6,624,332,53.21,292,46.79
4107,41,7,594,292,49.16,302,50.84
4108,41,8,566,262,46.29,304,53.71
4109,41,9,570,315,55.26,255,44.74
4110,41,10,558,288,51.61,270,48.39
4111,41,11,621,291,46.86,330,53.14
4112,41,12,621,294,47.34,327,52.66
4113,41,13,692,338,48.84,354,51.16
4114,41,14,601,359,59.73,242,40.27
4115,41,15,721,381,52.84,340,47.16
4116,41,16,539,283,52.5,256,47.5
4117,41,17,517,280,54.16,237,45.84
4118,41,18,533,275,51.59,258,48.41
4119,41,19,620,373,60.16,247,39.84
4120,41,20,432,214,49.54,218,50.46
4121,41,21,568,303,53.35,265,46.65
4122,41,22,643,328,51.01,315,48.99
4123,41,23,617,238,38.57,379,61.43
4124,41,24,546,249,45.6,297,54.4
4125,41,25,594,308,51.85,286,48.15
4126,41,26,506,255,50.4,251,49.6
4127,41,27,562,238,42.35,324,57.65
4128,41,28,649,371,57.16,278,42.84
4129,41,29,513,258,50.29,255,49.71
4130,41,30,560,302,53.93,258,46.07
4131,41,31,521,281,53.93,240,46.07
4132,41,32,484,245,50.62,239,49.38
4133,41,33,553,281,50.81,272,49.19
4134,41,34,542,274,50.55,268,49.45
4135,41,35,689,326,47.31,363,52.69
4136,41,36,565,290,51.33,275,48.67
4137,41,37,634,331,52.21,303,47.79
4138,41,38,576,306,53.13,270,46.88
4139,41,39,598,310,51.84,288,48.16
4140,41,40,644,283,43.94,361,56.06
4141,41,41,622,286,45.98,336,54.02
4142,41,42,578,268,46.37,310,53.63
4143,41,43,605,312,51.57,293,48.43
4144,41,44,568,236,41.55,332,58.45
4145,41,45,573,304,53.05,269,46.95
4146,41,46,577,292,50.61,285,49.39
4147,41,47,615,327,53.17,288,46.83
4201,42,1,561,364,64.88,197,35.12
4202,42,2,848,626,73.82,222,26.18
4203,42,3,701,550,78.46,151,21.54
4204,42,4,1682,1169,69.5,513,30.5
4205,42,5,580,405,69.83,175,30.17
4206,42,6,623,420,67.42,203,32.58
4207,42,7,777,526,67.7,251,32.3
4208,42,8,546,421,77.11,125,22.89
4209,42,9,896,682,76.12,214,23.88
4210,42,10,950,693,72.95,257,27.05
4211,42,11,452,291,64.38,161,35.62
4212,42,12,562,371,66.01,191,33.99
4213,42,13,513,338,65.89,175,34.11
4214,42,14,959,622,64.86,337,35.14
4215,42,15,973,625,64.23,348,35.77
4216,42,16,701,518,73.89,183,26.11
4217,42,17,1128,706,62.59,422,37.41
4218,42,18,896,620,69.2,276,30.8
4219,42,19,848,551,64.98,297,35.02
4220,42,20,892,559,62.67,333,37.33
4221,42,21,835,643,77.01,192,22.99
4222,42,22,399,251,62.91,148,37.09
4223,42,23,795,488,61.38,307,38.62
4224,42,24,637,423,66.41,214,33.59
4225,42,25,814,525,64.5,289,35.5
4226,42,26,1152,772,67.01,380,32.99
4227,42,27,468,336,71.79,132,28.21
4228,42,28,696,491,70.55,205,29.45
4229,42,29,816,528,64.71,288,35.29
4230,42,30,512,329,64.26,183,35.74
4231,42,31,852,564,66.2,288,33.8
4232,42,32,838,551,65.75,287,34.25
4233,42,33,744,579,77.82,165,22.18
4234,42,34,541,343,63.4,198,36.6
4235,42,35,862,646,74.94,216,25.06
4236,42,36,1239,866,69.9,373,30.1
4237,42,37,541,336,62.11,205,37.89
4238,42,38,673,435,64.64,238,35.36
4239,42,39,1257,857,68.18,400,31.82
4240,42,40,1027,745,72.54,282,27.46
4241,42,41,717,539,75.17,178,24.83
4242,42,42,1229,934,76.0,295,24.0
4301,43,1,356,271,76.12,85,23.88
4302,43,2,709,516,72.78,193,27.22
4303,43,3,622,431,69.29,191,30.71
4304,43,4,832,570,68.51,262,31.49
4305,43,5,612,434,70.92,178,29.08
4306,43,6,521,394,75.62,127,24.38
4307,43,7,415,302,72.77,113,27.23
4308,43,8,493,370,75.05,123,24.95
4309,43,9,676,493,72.93,183,27.07
4310,43,10,817,587,71.85,230,28.15
4311,43,11,631,416,65.93,215,34.07
4312,43,12,412,306,74.27,106,25.73
4313,43,13,640,504,78.75,136,21.25
4314,43,14,653,470,71.98,183,28.02
4315,43,15,663,470,70.89,193,29.11
4316,43,16,941,701,74.5,240,25.5
4317,43,17,527,356,67.55,171,32.45
4318,43,18,754,522,69.23,232,30.77
4319,43,19,661,483,73.07,178,26.93
4320,43,20,801,608,75.91,193,24.09
4321,43,21,765,571,74.64,194,25.36
4322,43,22,481,367,76.3,114,23.7
4323,43,23,472,334,70.76,138,29.24
4324,43,24,497,344,69.22,153,30.78
4325,43,25,526,399,75.86,127,24.14
4326,43,26,396,307,77.53,89,22.47
4327,43,27,587,426,72.57,161,27.43
4328,43,28,812,587,72.29,225,27.71
4329,43,29,926,681,73.54,245,26.46
4330,43,30,682,513,75.22,169,24.78
4331,43,31,617,453,73.42,164,26.58
4332,43,32,697,549,78.77,148,21.23
4333,43,33,655,441,67.33,214,32.67
4334,43,34,424,327,77.12,97,22.88
4335,43,35,660,443,67.12,217,32.88
4336,43,36,444,333,75.0,111,25.0
4337,43,37,750,597,79.6,153,20.4
4338,43,38,492,313,63.62,179,36.38
4339,43,39,529,368,69.57,161,30.43
4340,43,40,496,393,79.23,103,20.77
4341,43,41,794,581,73.17,213,26.83
4342,43,42,633,493,77.88,140,22.12
4343,43,43,667,449,67.32,218,32.68
4344,43,44,660,486,73.64,174,26.36
4345,43,45,394,288,73.1,106,26.9
4346,43,46,423,327,77.3,96,22.7
4401,44,1,1038,890,85.74,148,14.26
4402,44,2,716,542,75.7,174,24.3
4403,44,3,361,302,83.66,59,16.34
4404,44,4,542,441,81.37,101,18.63
4405,44,5,699,592,84.69,107,15.31
4406,44,6,911,755,82.88,156,17.12
4407,44,7,449,337,75.06,112,24.94
4408,44,8,956,809,84.62,147,15.38
4409,44,9,711,553,77.78,158,22.22
4410,44,10,775,586,75.61,189,24.39
4411,44,11,805,613,76.15,192,23.85
4412,44,12,737,597,81.0,140,19.0
4413,44,13,596,447,75.0,149,25.0
4414,44,14,664,529,79.67,135,20.33
4415,44,15,656,544,82.93,112,17.07
4416,44,16,826,659,79.78,167,20.22
4417,44,17,908,790,87.0,118,13.0
4418,44,18,809,626,77.38,183,22.62
4419,44,19,834,688,82.49,146,17.51
4420,44,20,851,696,81.79,155,18.21
4421,44,21,822,700,85.16,122,14.84
4422,44,22,662,543,82.02,119,17.98
4423,44,23,663,558,84.16,105,15.84
4424,44,24,480,371,77.29,109,22.71
4425,44,25,717,588,82.01,129,17.99
4426,44,26,873,748,85.68,125,14.32
4427,44,27,823,656,79.71,167,20.29
4428,44,28,742,626,84.37,116,15.63
4429,44,29,832,663,79.69,169,20.31
4430,44,30,865,689,79.65,176,20.35
4431,44,31,641,493,76.91,148,23.09
4432,44,32,826,648,78.45,178,21.55
4433,44,33,753,683,90.7,70,9.3
4434,44,34,731,635,86.87,96,13.13
4435,44,35,774,611,78.94,163,21.06
4436,44,36,794,654,82.37,140,17.63
4437,44,37,772,659,85.36,113,14.64
4438,44,38,884,654,73.98,230,26.02
4439,44,39,762,595,78.08,167,21.92
4440,44,40,707,524,74.12,183,25.88
4441,44,41,934,781,83.62,153,16.38
4501,45,1,453,387,85.43,66,14.57
4502,45,2,555,484,87.21,71,12.79
4503,45,3,501,414,82.63,87,17.37
4504,45,4,657,513,78.08,144,21.92
4505,45,5,589,451,76.57,138,23.43
4506,45,6,740,589,79.59,151,20.41
4507,45,7,796,601,75.5,195,24.5
4508,45,8,565,434,76.81,131,23.19
4509,45,9,558,416,74.55,142,25.45
4510,45,10,569,427,75.04,142,24.96
4511,45,11,435,325,74.71,110,25.29
4512,45,12,536,394,73.51,142,26.49
4513,45,13,453,343,75.72,110,24.28
4514,45,14,798,619,77.57,179,22.43
4515,45,15,656,527,80.34,129,19.66
4516,45,16,461,335,72.67,126,27.33
4517,45,17,625,422,67.52,203,32.48
4518,45,18,615,407,66.18,208,33.82
4519,45,19,319,215,67.4,104,32.6
4520,45,20,410,292,71.22,118,28.78
4521,45,21,501,315,62.87,186,37.13
4522,45,22,555,352,63.42,203,36.58
4523,45,23,532,319,59.96,213,40.04
4524,45,24,439,257,58.54,182,41.46
4525,45,25,360,216,60.0,144,40.0
4526,45,26,330,171,51.82,159,48.18
4527,45,27,542,322,59.41,220,40.59
4528,45,28,467,307,65.74,160,34.26
4529,45,29,378,231,61.11,147,38.89
4530,45,30,519,400,77.07,119,22.93
4531,45,31,460,350,76.09,110,23.91
4532,45,32,523,369,70.55,154,29.45
4533,45,33,394,298,75.63,96,24.37
4534,45,34,580,395,68.1,185,31.9
4535,45,35,595,407,68.4,188,31.6
4536,45,36,573,375,65.45,198,34.55
4537,45,37,543,339,62.43,204,37.57
4538,45,38,557,376,67.5,181,32.5
4539,45,39,554,348,62.82,206,37.18
4540,45,40,518,306,59.07,212,40.93
4541,45,41,504,304,60.32,200,39.68
4542,45,42,515,309,60.0,206,40.0
4543,45,43,578,309,53.46,269,46.54
4544,45,44,531,300,56.5,231,43.5
4545,45,45,384,196,51.04,188,48.96
4546,45,46,434,241,55.53,193,44.47
4547,45,47,401,225,56.11,176,43.89
4548,45,48,467,226,48.39,241,51.61
4601,46,1,479,410,85.59,69,14.41
4602,46,2,625,557,89.12,68,10.88
4603,46,3,760,624,82.11,136,17.89
4604,46,4,609,551,90.48,58,9.52
4605,46,5,870,711,81.72,159,18.28
4606,46,6,575,508,88.35,67,11.65
4607,46,7,670,547,81.64,123,18.36
4608,46,8,462,418,90.48,44,9.52
4609,46,9,710,633,89.15,77,10.85
4610,46,10,1138,976,85.76,162,14.24
4611,46,11,674,531,78.78,143,21.22
4612,46,12,703,642,91.32,61,8.68
4613,46,13,677,590,87.15,87,12.85
4614,46,14,727,621,85.42,106,14.58
4615,46,15,681,577,84.73,104,15.27
4616,46,16,712,627,88.06,85,11.94
4617,46,17,696,571,82.04,125,17.96
4618,46,18,765,603,78.82,162,21.18
4619,46,19,444,357,80.41,87,19.59
4620,46,20,557,495,88.87,62,11.13
4621,46,21,510,409,80.2,101,19.8
4622,46,22,457,406,88.84,51,11.16
4623,46,23,586,532,90.78,54,9.22
4624,46,24,807,688,85.25,119,14.75
4625,46,25,618,566,91.59,52,8.41
4626,46,26,908,809,89.1,99,10.9
4627,46,27,856,754,88.08,102,11.92
4628,46,28,600,488,81.33,112,18.67
4629,46,29,537,439,81.75,98,18.25
4630,46,30,695,603,86.76,92,13.24
4631,46,31,679,609,89.69,70,10.31
4632,46,32,631,543,86.05,88,13.95
4633,46,33,700,591,84.43,109,15.57
4634,46,34,825,736,89.21,89,10.79
4635,46,35,733,644,87.86,89,12.14
4636,46,36,609,487,79.97,122,20.03
4637,46,37,531,465,87.57,66,12.43
4638,46,38,771,674,87.42,97,12.58
4639,46,39,622,497,79.9,125,20.1
4640,46,40,540,467,86.48,73,13.52
4701,47,1,469,380,81.02,89,18.98
4702,47,2,652,522,80.06,130,19.94
4703,47,3,628,507,80.73,121,19.27
4704,47,4,782,639,81.71,143,18.29
4705,47,5,702,610,86.89,92,13.11
4706,47,6,807,684,84.76,123,15.24
4707,47,7,632,511,80.85,121,19.15
4708,47,8,647,527,81.45,120,18.55
4709,47,9,653,517,79.17,136,20.83
4710,47,10,795,702,88.3,93,11.7
4711,47,11,696,554,79.6,142,20.4
4712,47,12,718,615,85.65,103,14.35
4713,47,13,651,551,84.64,100,15.36
4714,47,14,615,507,82.44,108,17.56
4715,47,15,788,734,93.15,54,6.85
4716,47,16,653,527,80.7,126,19.3
4717,47,17,665,524,78.8,141,21.2
4718,47,18,638,509,79.78,129,20.22
4719,47,19,1043,963,92.33,80,7.67
4720,47,20,675,584,86.52,91,13.48
4721,47,21,641,547,85.34,94,14.66
4722,47,22,720,600,83.33,120,16.67
4723,47,23,747,676,90.5,71,9.5
4724,47,24,713,606,84.99,107,15.01
4725,47,25,826,698,84.5,128,15.5
4726,47,26,900,819,91.0,81,9.0
4727,47,27,575,468,81.39,107,18.61
4728,47,28,621,531,85.51,90,14.49
4729,47,29,782,641,81.97,141,18.03
4730,47,30,831,754,90.73,77,9.27
4731,47,31,694,609,87.75,85,12.25
4732,47,32,797,717,89.96,80,10.04
4733,47,33,698,563,80.66,135,19.34
4734,47,34,685,593,86.57,92,13.43
4735,47,35,661,524,79.27,137,20.73
4736,47,36,756,674,89.15,82,10.85
4737,47,37,631,550,87.16,81,12.84
4738,47,38,676,584,86.39,92,13.61
4739,47,39,673,575,85.44,98,14.56
4740,47,40,621,541,87.12,80,12.88
4741,47,41,721,630,87.38,91,12.62
4742,47,42,634,553,87.22,81,12.78
4743,47,43,618,478,77.35,140,22.65
4744,47,44,607,495,81.55,112,18.45
4745,47,45,601,519,86.36,82,13.64
4746,47,46,707,541,76.52,166,23.48
4747,47,47,815,663,81.35,152,18.65
4748,47,48,47,38,80.85,9,19.15
4801,48,1,616,563,91.4,53,8.6
4802,48,2,280,234,83.57,46,16.43
4803,48,3,719,629,87.48,90,12.52
4804,48,4,591,542,91.71,49,8.29
4805,48,5,341,288,84.46,53,15.54
4806,48,6,759,658,86.69,101,13.31
4807,48,7,653,607,92.96,46,7.04
4808,48,8,318,253,79.56,65,20.44
4809,48,9,435,321,73.79,114,26.21
4810,48,10,860,789,91.74,71,8.26
4811,48,11,505,452,89.5,53,10.5
4812,48,12,785,698,88.92,87,11.08
4813,48,13,805,657,81.61,148,18.39
4814,48,14,307,241,78.5,66,21.5
4815,48,15,400,328,82.0,72,18.0
4816,48,16,693,610,88.02,83,11.98
4817,48,17,540,479,88.7,61,11.3
4818,48,18,413,348,84.26,65,15.74
4819,48,19,429,385,89.74,44,10.26
4820,48,20,653,588,90.05,65,9.95
4821,48,21,812,700,86.21,112,13.79
4822,48,22,484,380,78.51,104,21.49
4823,48,23,572,464,81.12,108,18.88
4824,48,24,765,558,72.94,207,27.06
4825,48,25,515,447,86.8,68,13.2
4826,48,26,316,261,82.59,55,17.41
4827,48,27,625,557,89.12,68,10.88
4828,48,28,742,562,75.74,180,24.26
4829,48,29,278,233,83.81,45,16.19
4830,48,30,525,476,90.67,49,9.33
4831,48,31,895,785,87.71,110,12.29
4832,48,32,681,613,90.01,68,9.99
4833,48,33,332,284,85.54,48,14.46
4834,48,34,536,474,88.43,62,11.57
4835,48,35,395,316,80.0,79,20.0
4836,48,36,354,292,82.49,62,17.51
4837,48,37,664,586,88.25,78,11.75
4838,48,38,617,534,86.55,83,13.45
4839,48,39,489,399,81.6,90,18.4
4840,48,40,551,500,90.74,51,9.26
4841,48,41,801,730,91.14,71,8.86
4842,48,42,681,640,93.98,41,6.02
4843,48,43,733,648,88.4,85,11.6
4844,48,44,776,716,92.27,60,7.73
4845,48,45,459,421,91.72,38,8.28
4846,48,46,404,345,85.4,59,14.6
4901,49,1,404,386,95.54,18,4.46
4902,49,2,387,363,93.8,24,6.2
4903,49,3,774,717,92.64,57,7.36
4904,49,4,808,738,91.34,70,8.66
4905,49,5,583,529,90.74,54,9.26
4906,49,6,554,503,90.79,51,9.21
4907,49,7,517,447,86.46,70,13.54
4908,49,8,558,502,89.96,56,10.04
4909,49,9,653,579,88.67,74,11.33
4910,49,10,713,633,88.78,80,11.22
4911,49,11,796,736,92.46,60,7.54
4912,49,12,760,681,89.61,79,10.39
4913,49,13,727,645,88.72,82,11.28
4914,49,14,501,445,88.82,56,11.18
4915,49,15,473,426,90.06,47,9.94
4916,49,16,576,495,85.94,81,14.06
4917,49,17,485,408,84.12,77,15.88
4918,49,18,782,719,91.94,63,8.06
4919,49,19,603,554,91.87,49,8.13
4920,49,20,953,881,92.44,72,7.56
4921,49,21,398,341,85.68,57,14.32
4922,49,22,665,596,89.62,69,10.38
4923,49,23,812,720,88.67,92,11.33
4924,49,24,517,481,93.04,36,6.96
4925,49,25,800,709,88.63,91,11.38
4926,49,26,750,663,88.4,87,11.6
4927,49,27,722,657,91.0,65,9.0
4928,49,28,885,806,91.07,79,8.93
4929,49,29,759,686,90.38,73,9.62
4930,49,30,669,587,87.74,82,12.26
4931,49,31,457,399,87.31,58,12.69
4932,49,32,590,538,91.19,52,8.81
4933,49,33,489,446,91.21,43,8.79
5001,50,1,492,261,53.05,231,46.95
5002,50,2,327,189,57.8,138,42.2
5003,50,3,447,254,56.82,193,43.18
5004,50,4,564,419,74.29,145,25.71
5005,50,5,360,167,46.39,193,53.61
5006,50,6,528,400,75.76,128,24.24
5007,50,7,576,489,84.9,87,15.1
5008,50,8,507,439,86.59,68,13.41
5009,50,9,427,300,70.26,127,29.74
5010,50,10,546,303,55.49,243,44.51
5011,50,11,334,108,32.34,226,67.66
5012,50,12,235,131,55.74,104,44.26
5013,50,13,613,518,84.5,95,15.5
5014,50,14,178,91,51.12,87,48.88
5015,50,15,584,479,82.02,105,17.98
5016,50,16,165,92,55.76,73,44.24
5017,50,17,565,378,66.9,187,33.1
5018,50,18,82,28,34.15,54,65.85
5019,50,19,409,336,82.15,73,17.85
5020,50,20,520,408,78.46,112,21.54
5021,50,21,466,345,74.03,121,25.97
5022,50,22,480,281,58.54,199,41.46
5023,50,23,383,240,62.66,143,37.34
5024,50,24,384,148,38.54,236,61.46
5025,50,25,509,240,47.15,269,52.85
5026,50,26,550,376,68.36,174,31.64
5027,50,27,179,100,55.87,79,44.13
5028,50,28,540,445,82.41,95,17.59
5029,50,29,521,423,81.19,98,18.81
5030,50,30,392,324,82.65,68,17.35
5031,50,31,675,582,86.22,93,13.78
5032,50,32,587,506,86.2,81,13.8
5033,50,33,374,165,44.12,209,55.88
5034,50,34,650,439,67.54,211,32.46
5035,50,35,631,531,84.15,100,15.85
5036,50,36,515,401,77.86,114,22.14
5037,50,37,522,441,84.48,81,15.52
5038,50,38,199,125,62.81,74,37.19
5039,50,39,344,214,62.21,130,37.79
5040,50,40,485,166,34.23,319,65.77
