id,ward,precinct,total,Fritz Kaegi,Fritz Kaegi Percent,Kari K. Steele,Kari K. Steele Percent
0101,1,1,186,128,68.82,58,31.18
0102,1,2,134,96,71.64,38,28.36
0103,1,3,195,105,53.85,90,46.15
0104,1,4,158,95,60.13,63,39.87
0105,1,5,145,105,72.41,40,27.59
0106,1,6,146,91,62.33,55,37.67
0107,1,7,140,91,65.0,49,35.0
0108,1,8,151,80,52.98,71,47.02
0109,1,9,123,72,58.54,51,41.46
0110,1,10,189,130,68.78,59,31.22
0111,1,11,192,127,66.15,65,33.85
0112,1,12,196,131,66.84,65,33.16
0113,1,13,90,67,74.44,23,25.56
0114,1,14,173,109,63.01,64,36.99
0115,1,15,146,90,61.64,56,38.36
0116,1,16,207,140,67.63,67,32.37
0117,1,17,146,104,71.23,42,28.77
0118,1,18,172,113,65.7,59,34.3
0119,1,19,241,159,65.98,82,34.02
0120,1,20,135,96,71.11,39,28.89
0121,1,21,204,130,63.73,74,36.27
0122,1,22,116,72,62.07,44,37.93
0123,1,23,253,184,72.73,69,27.27
0124,1,24,194,108,55.67,86,44.33
0125,1,25,163,114,69.94,49,30.06
0126,1,26,117,84,71.79,33,28.21
0127,1,27,187,133,71.12,54,28.88
0128,1,28,32,14,43.75,18,56.25
0129,1,29,231,157,67.97,74,32.03
0130,1,30,212,145,68.4,67,31.6
0131,1,31,138,95,68.84,43,31.16
0132,1,32,158,95,60.13,63,39.87
0133,1,33,199,137,68.84,62,31.16
0134,1,34,171,123,71.93,48,28.07
0135,1,35,168,99,58.93,69,41.07
0136,1,36,205,132,64.39,73,35.61
0137,1,37,179,117,65.36,62,34.64
0138,1,38,155,94,60.65,61,39.35
0139,1,39,136,82,60.29,54,39.71
0140,1,40,134,71,52.99,63,47.01
0141,1,41,96,65,67.71,31,32.29
0142,1,42,43,28,65.12,15,34.88
0143,1,43,131,91,69.47,40,30.53
0144,1,44,150,105,70.0,45,30.0
0201,2,1,151,88,58.28,63,41.72
0202,2,2,141,96,68.09,45,31.91
0203,2,3,187,122,65.24,65,34.76
0204,2,4,164,105,64.02,59,35.98
0205,2,5,176,102,57.95,74,42.05
0206,2,6,136,92,67.65,44,32.35
0207,2,7,120,84,70.0,36,30.0
0208,2,8,157,87,55.41,70,44.59
0209,2,9,155,85,54.84,70,45.16
0210,2,10,145,91,62.76,54,37.24
0211,2,11,187,132,70.59,55,29.41
0212,2,12,122,70,57.38,52,42.62
0213,2,13,194,126,64.95,68,35.05
0214,2,14,187,126,67.38,61,32.62
0215,2,15,142,95,66.9,47,33.1
0216,2,16,169,109,64.5,60,35.5
0217,2,17,245,170,69.39,75,30.61
0218,2,18,147,90,61.22,57,38.78
0219,2,19,130,89,68.46,41,31.54
0220,2,20,149,108,72.48,41,27.52
0221,2,21,181,120,66.3,61,33.7
0222,2,22,183,112,61.2,71,38.8
0223,2,23,139,96,69.06,43,30.94
0224,2,24,136,81,59.56,55,40.44
0225,2,25,199,125,62.81,74,37.19
0226,2,26,116,72,62.07,44,37.93
0227,2,27,115,74,64.35,41,35.65
0228,2,28,155,95,61.29,60,38.71
0229,2,29,145,92,63.45,53,36.55
0230,2,30,129,89,68.99,40,31.01
0231,2,31,211,149,70.62,62,29.38
0232,2,32,87,51,58.62,36,41.38
0233,2,33,208,148,71.15,60,28.85
0234,2,34,157,109,69.43,48,30.57
0235,2,35,175,93,53.14,82,46.86
0236,2,36,158,88,55.7,70,44.3
0237,2,37,179,124,69.27,55,30.73
0238,2,38,147,104,70.75,43,29.25
0239,2,39,73,44,60.27,29,39.73
0240,2,40,157,76,48.41,81,51.59
0241,2,41,134,77,57.46,57,42.54
0242,2,42,130,74,56.92,56,43.08
0243,2,43,162,105,64.81,57,35.19
0244,2,44,171,116,67.84,55,32.16
0245,2,45,97,61,62.89,36,37.11
0246,2,46,97,60,61.86,37,38.14
0301,3,1,195,40,20.51,155,79.49
0302,3,2,279,61,21.86,218,78.14
0303,3,3,114,45,39.47,69,60.53
0304,3,4,231,51,22.08,180,77.92
0305,3,5,87,19,21.84,68,78.16
0306,3,6,258,138,53.49,120,46.51
0307,3,7,167,44,26.35,123,73.65
0308,3,8,108,17,15.74,91,84.26
0309,3,9,194,33,17.01,161,82.99
0310,3,10,72,25,34.72,47,65.28
0311,3,11,170,39,22.94,131,77.06
0312,3,12,269,70,26.02,199,73.98
0313,3,13,223,141,63.23,82,36.77
0314,3,14,182,91,50.0,91,50.0
0315,3,15,129,22,17.05,107,82.95
0316,3,16,144,34,23.61,110,76.39
0317,3,17,194,70,36.08,124,63.92
0318,3,18,227,75,33.04,152,66.96
0319,3,19,219,123,56.16,96,43.84
0320,3,20,199,63,31.66,136,68.34
0321,3,21,237,89,37.55,148,62.45
0322,3,22,225,117,52.0,108,48.0
0323,3,23,129,37,28.68,92,71.32
0324,3,24,133,27,20.3,106,79.7
0325,3,25,339,192,56.64,147,43.36
0326,3,26,252,133,52.78,119,47.22
0327,3,27,227,112,49.34,115,50.66
0328,3,28,133,32,24.06,101,75.94
0329,3,29,126,31,24.6,95,75.4
0330,3,30,180,42,23.33,138,76.67
0331,3,31,165,38,23.03,127,76.97
0332,3,32,236,108,45.76,128,54.24
0333,3,33,202,111,54.95,91,45.05
0334,3,34,252,121,48.02,131,51.98
0335,3,35,96,25,26.04,71,73.96
0336,3,36,63,15,23.81,48,76.19
0337,3,37,124,32,25.81,92,74.19
0338,3,38,187,44,23.53,143,76.47
0339,3,39,297,155,52.19,142,47.81
0340,3,40,151,59,39.07,92,60.93
0341,3,41,188,69,36.7,119,63.3
0401,4,1,270,167,61.85,103,38.15
0402,4,2,252,148,58.73,104,41.27
0403,4,3,125,30,24.0,95,76.0
0404,4,4,244,55,22.54,189,77.46
0405,4,5,223,72,32.29,151,67.71
0406,4,6,324,96,29.63,228,70.37
0407,4,7,266,85,31.95,181,68.05
0408,4,8,258,88,34.11,170,65.89
0409,4,9,348,126,36.21,222,63.79
0410,4,10,320,104,32.5,216,67.5
0411,4,11,112,34,30.36,78,69.64
0412,4,12,223,64,28.7,159,71.3
0413,4,13,126,79,62.7,47,37.3
0414,4,14,228,80,35.09,148,64.91
0415,4,15,234,59,25.21,175,74.79
0416,4,16,296,186,62.84,110,37.16
0417,4,17,233,145,62.23,88,37.77
0418,4,18,231,69,29.87,162,70.13
0419,4,19,106,27,25.47,79,74.53
0420,4,20,201,131,65.17,70,34.83
0421,4,21,175,111,63.43,64,36.57
0422,4,22,234,128,54.7,106,45.3
0423,4,23,285,185,64.91,100,35.09
0424,4,24,180,94,52.22,86,47.78
0425,4,25,266,160,60.15,106,39.85
0426,4,26,166,67,40.36,99,59.64
0427,4,27,262,135,51.53,127,48.47
0428,4,28,159,49,30.82,110,69.18
0429,4,29,197,74,37.56,123,62.44
0430,4,30,202,49,24.26,153,75.74
0431,4,31,317,123,38.8,194,61.2
0432,4,32,227,66,29.07,161,70.93
0433,4,33,185,71,38.38,114,61.62
0434,4,34,176,58,32.95,118,67.05
0435,4,35,278,85,30.58,193,69.42
0436,4,36,287,101,35.19,186,64.81
0437,4,37,337,219,64.99,118,35.01
0438,4,38,264,89,33.71,175,66.29
0501,5,1,118,32,27.12,86,72.88
0502,5,2,104,27,25.96,77,74.04
0503,5,3,195,138,70.77,57,29.23
0504,5,4,258,115,44.57,143,55.43
0505,5,5,159,47,29.56,112,70.44
0506,5,6,144,38,26.39,106,73.61
0507,5,7,198,75,37.88,123,62.12
0508,5,8,231,190,82.25,41,17.75
0509,5,9,276,132,47.83,144,52.17
0510,5,10,106,26,24.53,80,75.47
0511,5,11,229,134,58.52,95,41.48
0512,5,12,89,23,25.84,66,74.16
0513,5,13,146,26,17.81,120,82.19
0514,5,14,230,81,35.22,149,64.78
0515,5,15,187,82,43.85,105,56.15
0516,5,16,163,36,22.09,127,77.91
0517,5,17,113,30,26.55,83,73.45
0518,5,18,179,112,62.57,67,37.43
0519,5,19,234,178,76.07,56,23.93
0520,5,20,311,145,46.62,166,53.38
0521,5,21,196,123,62.76,73,37.24
0522,5,22,338,184,54.44,154,45.56
0523,5,23,350,208,59.43,142,40.57
0524,5,24,236,136,57.63,100,42.37
0525,5,25,197,86,43.65,111,56.35
0526,5,26,164,49,29.88,115,70.12
0527,5,27,174,141,81.03,33,18.97
0528,5,28,215,73,33.95,142,66.05
0529,5,29,182,57,31.32,125,68.68
0530,5,30,90,27,30.0,63,70.0
0531,5,31,103,25,24.27,78,75.73
0532,5,32,224,67,29.91,157,70.09
0533,5,33,198,43,21.72,155,78.28
0534,5,34,240,200,83.33,40,16.67
0535,5,35,281,171,60.85,110,39.15
0536,5,36,64,10,15.63,54,84.38
0537,5,37,272,190,69.85,82,30.15
0538,5,38,143,29,20.28,114,79.72
0539,5,39,208,139,66.83,69,33.17
0540,5,40,132,32,24.24,100,75.76
0541,5,41,177,91,51.41,86,48.59
0601,6,1,181,37,20.44,144,79.56
0602,6,2,210,37,17.62,173,82.38
0603,6,3,161,35,21.74,126,78.26
0604,6,4,79,18,22.78,61,77.22
0605,6,5,78,19,24.36,59,75.64
0606,6,6,168,49,29.17,119,70.83
0607,6,7,95,23,24.21,72,75.79
0608,6,8,193,49,25.39,144,74.61
0609,6,9,102,31,30.39,71,69.61
0610,6,10,64,12,18.75,52,81.25
0611,6,11,108,33,30.56,75,69.44
0612,6,12,63,15,23.81,48,76.19
0613,6,13,133,39,29.32,94,70.68
0614,6,14,141,23,16.31,118,83.69
0615,6,15,85,24,28.24,61,71.76
0616,6,16,178,50,28.09,128,71.91
0617,6,17,72,18,25.0,54,75.0
0618,6,18,96,23,23.96,73,76.04
0619,6,19,97,26,26.8,71,73.2
0620,6,20,75,23,30.67,52,69.33
0621,6,21,49,12,24.49,37,75.51
0622,6,22,62,11,17.74,51,82.26
0623,6,23,54,11,20.37,43,79.63
0624,6,24,56,15,26.79,41,73.21
0625,6,25,63,18,28.57,45,71.43
0626,6,26,67,17,25.37,50,74.63
0627,6,27,67,17,25.37,50,74.63
0628,6,28,44,8,18.18,36,81.82
0629,6,29,203,47,23.15,156,76.85
0630,6,30,89,25,28.09,64,71.91
0631,6,31,189,55,29.1,134,70.9
0632,6,32,148,36,24.32,112,75.68
0633,6,33,154,31,20.13,123,79.87
0634,6,34,143,33,23.08,110,76.92
0635,6,35,169,25,14.79,144,85.21
0636,6,36,205,41,20.0,164,80.0
0637,6,37,228,65,28.51,163,71.49
0638,6,38,195,39,20.0,156,80.0
0639,6,39,122,32,26.23,90,73.77
0640,6,40,114,34,29.82,80,70.18
0641,6,41,172,36,20.93,136,79.07
0642,6,42,128,28,21.88,100,78.13
0643,6,43,129,27,20.93,102,79.07
0644,6,44,138,29,21.01,109,78.99
0645,6,45,167,40,23.95,127,76.05
0646,6,46,109,20,18.35,89,81.65
0647,6,47,116,20,17.24,96,82.76
0648,6,48,120,32,26.67,88,73.33
0701,7,1,100,25,25.0,75,75.0
0702,7,2,98,26,26.53,72,73.47
0703,7,3,138,36,26.09,102,73.91
0704,7,4,121,35,28.93,86,71.07
0705,7,5,92,26,28.26,66,71.74
0706,7,6,180,64,35.56,116,64.44
0707,7,7,96,25,26.04,71,73.96
0708,7,8,111,31,27.93,80,72.07
0709,7,9,262,66,25.19,196,74.81
0710,7,10,185,56,30.27,129,69.73
0711,7,11,110,26,23.64,84,76.36
0712,7,12,84,21,25.0,63,75.0
0713,7,13,110,29,26.36,81,73.64
0714,7,14,121,31,25.62,90,74.38
0715,7,15,141,39,27.66,102,72.34
0716,7,16,87,21,24.14,66,75.86
0717,7,17,102,37,36.27,65,63.73
0718,7,18,105,30,28.57,75,71.43
0719,7,19,118,32,27.12,86,72.88
0720,7,20,75,19,25.33,56,74.67
0721,7,21,78,28,35.9,50,64.1
0722,7,22,100,29,29.0,71,71.0
0723,7,23,161,51,31.68,110,68.32
0724,7,24,86,24,27.91,62,72.09
0725,7,25,59,22,37.29,37,62.71
0726,7,26,125,30,24.0,95,76.0
0727,7,27,109,21,19.27,88,80.73
0728,7,28,77,17,22.08,60,77.92
0729,7,29,115,35,30.43,80,69.57
0730,7,30,80,21,26.25,59,73.75
0731,7,31,66,24,36.36,42,63.64
0732,7,32,242,70,28.93,172,71.07
0733,7,33,240,66,27.5,174,72.5
0734,7,34,191,44,23.04,147,76.96
0735,7,35,121,40,33.06,81,66.94
0736,7,36,185,46,24.86,139,75.14
0737,7,37,166,56,33.73,110,66.27
0738,7,38,111,28,25.23,83,74.77
0739,7,39,121,34,28.1,87,71.9
0740,7,40,119,39,32.77,80,67.23
0741,7,41,99,22,22.22,77,77.78
0742,7,42,125,33,26.4,92,73.6
0743,7,43,125,33,26.4,92,73.6
0744,7,44,109,29,26.61,80,73.39
0745,7,45,78,22,28.21,56,71.79
0746,7,46,61,16,26.23,45,73.77
0801,8,1,101,20,19.8,81,80.2
0802,8,2,101,30,29.7,71,70.3
0803,8,3,234,52,22.22,182,77.78
0804,8,4,199,52,26.13,147,73.87
0805,8,5,214,47,21.96,167,78.04
0806,8,6,178,37,20.79,141,79.21
0807,8,7,194,60,30.93,134,69.07
0808,8,8,215,52,24.19,163,75.81
0809,8,9,93,19,20.43,74,79.57
0810,8,10,277,80,28.88,197,71.12
0811,8,11,101,20,19.8,81,80.2
0812,8,12,123,29,23.58,94,76.42
0813,8,13,143,24,16.78,119,83.22
0814,8,14,59,10,16.95,49,83.05
0815,8,15,124,22,17.74,102,82.26
0816,8,16,34,2,5.88,32,94.12
0817,8,17,159,45,28.3,114,71.7
0818,8,18,66,13,19.7,53,80.3
0819,8,19,222,58,26.13,164,73.87
0820,8,20,190,41,21.58,149,78.42
0821,8,21,169,35,20.71,134,79.29
0822,8,22,144,35,24.31,109,75.69
0823,8,23,87,20,22.99,67,77.01
0824,8,24,100,24,24.0,76,76.0
0825,8,25,126,27,21.43,99,78.57
0826,8,26,97,18,18.56,79,81.44
0827,8,27,240,59,24.58,181,75.42
0828,8,28,155,36,23.23,119,76.77
0829,8,29,193,44,22.8,149,77.2
0830,8,30,170,39,22.94,131,77.06
0831,8,31,110,27,24.55,83,75.45
0832,8,32,116,26,22.41,90,77.59
0833,8,33,114,26,22.81,88,77.19
0834,8,34,153,43,28.1,110,71.9
0835,8,35,190,40,21.05,150,78.95
0836,8,36,159,45,28.3,114,71.7
0837,8,37,145,37,25.52,108,74.48
0838,8,38,102,24,23.53,78,76.47
0839,8,39,143,34,23.78,109,76.22
0840,8,40,106,26,24.53,80,75.47
0841,8,41,146,27,18.49,119,81.51
0842,8,42,179,47,26.26,132,73.74
0843,8,43,53,10,18.87,43,81.13
0844,8,44,101,21,20.79,80,79.21
0845,8,45,68,19,27.94,49,72.06
0846,8,46,111,24,21.62,87,78.38
0847,8,47,131,30,22.9,101,77.1
0848,8,48,133,40,30.08,93,69.92
0849,8,49,153,26,16.99,127,83.01
0850,8,50,169,33,19.53,136,80.47
0851,8,51,189,41,21.69,148,78.31
0852,8,52,254,44,17.32,210,82.68
0853,8,53,78,18,23.08,60,76.92
0854,8,54,74,17,22.97,57,77.03
0855,8,55,148,26,17.57,122,82.43
0856,8,56,198,39,19.7,159,80.3
0901,9,1,129,29,22.48,100,77.52
0902,9,2,97,29,29.9,68,70.1
0903,9,3,48,14,29.17,34,70.83
0904,9,4,98,29,29.59,69,70.41
0905,9,5,152,47,30.92,105,69.08
0906,9,6,110,28,25.45,82,74.55
0907,9,7,66,14,21.21,52,78.79
0908,9,8,85,32,37.65,53,62.35
0909,9,9,167,38,22.75,129,77.25
0910,9,10,90,32,35.56,58,64.44
0911,9,11,98,28,28.57,70,71.43
0912,9,12,180,47,26.11,133,73.89
0913,9,13,174,58,33.33,116,66.67
0914,9,14,175,42,24.0,133,76.0
0915,9,15,49,6,12.24,43,87.76
0916,9,16,124,32,25.81,92,74.19
0917,9,17,58,9,15.52,49,84.48
0918,9,18,106,35,33.02,71,66.98
0919,9,19,112,40,35.71,72,64.29
0920,9,20,127,31,24.41,96,75.59
0921,9,21,103,32,31.07,71,68.93
0922,9,22,144,39,27.08,105,72.92
0923,9,23,179,32,17.88,147,82.12
0924,9,24,172,42,24.42,130,75.58
0925,9,25,128,27,21.09,101,78.91
0926,9,26,72,14,19.44,58,80.56
0927,9,27,119,36,30.25,83,69.75
0928,9,28,49,12,24.49,37,75.51
0929,9,29,67,22,32.84,45,67.16
0930,9,30,89,24,26.97,65,73.03
0931,9,31,78,20,25.64,58,74.36
0932,9,32,138,32,23.19,106,76.81
0933,9,33,86,30,34.88,56,65.12
0934,9,34,92,20,21.74,72,78.26
0935,9,35,149,40,26.85,109,73.15
0936,9,36,97,13,13.4,84,86.6
0937,9,37,206,104,50.49,102,49.51
0938,9,38,101,21,20.79,80,79.21
0939,9,39,157,44,28.03,113,71.97
0940,9,40,184,51,27.72,133,72.28
0941,9,41,109,35,32.11,74,67.89
0942,9,42,183,49,26.78,134,73.22
0943,9,43,90,19,21.11,71,78.89
0944,9,44,129,29,22.48,100,77.52
0945,9,45,92,46,50.0,46,50.0
0946,9,46,130,40,30.77,90,69.23
0947,9,47,182,45,24.73,137,75.27
0948,9,48,174,42,24.14,132,75.86
0949,9,49,180,46,25.56,134,74.44
0950,9,50,230,54,23.48,176,76.52
0951,9,51,178,39,21.91,139,78.09
1001,10,1,118,34,28.81,84,71.19
1002,10,2,81,50,61.73,31,38.27
1003,10,3,95,44,46.32,51,53.68
1004,10,4,53,22,41.51,31,58.49
1005,10,5,70,44,62.86,26,37.14
1006,10,6,76,36,47.37,40,52.63
1007,10,7,46,21,45.65,25,54.35
1008,10,8,28,9,32.14,19,67.86
1009,10,9,67,45,67.16,22,32.84
1010,10,10,94,54,57.45,40,42.55
1011,10,11,82,50,60.98,32,39.02
1012,10,12,50,28,56.0,22,44.0
1013,10,13,87,43,49.43,44,50.57
1014,10,14,98,58,59.18,40,40.82
1015,10,15,215,60,27.91,155,72.09
1016,10,16,57,32,56.14,25,43.86
1017,10,17,126,78,61.9,48,38.1
1018,10,18,44,20,45.45,24,54.55
1019,10,19,63,38,60.32,25,39.68
1020,10,20,83,45,54.22,38,45.78
1021,10,21,73,47,64.38,26,35.62
1022,10,22,27,14,51.85,13,48.15
1023,10,23,71,40,56.34,31,43.66
1024,10,24,73,33,45.21,40,54.79
1025,10,25,36,14,38.89,22,61.11
1026,10,26,58,25,43.1,33,56.9
1027,10,27,60,26,43.33,34,56.67
1028,10,28,84,53,63.1,31,36.9
1029,10,29,67,41,61.19,26,38.81
1030,10,30,58,41,70.69,17,29.31
1031,10,31,51,30,58.82,21,41.18
1032,10,32,72,43,59.72,29,40.28
1033,10,33,58,32,55.17,26,44.83
1034,10,34,39,15,38.46,24,61.54
1035,10,35,103,69,66.99,34,33.01
1036,10,36,35,10,28.57,25,71.43
1101,11,1,148,102,68.92,46,31.08
1102,11,2,5,3,60.0,2,40.0
1103,11,3,164,107,65.24,57,34.76
1104,11,4,117,85,72.65,32,27.35
1105,11,5,157,100,63.69,57,36.31
1106,11,6,208,120,57.69,88,42.31
1107,11,7,92,55,59.78,37,40.22
1108,11,8,123,74,60.16,49,39.84
1109,11,9,104,67,64.42,37,35.58
1110,11,10,99,64,64.65,35,35.35
1111,11,11,122,65,53.28,57,46.72
1112,11,12,150,90,60.0,60,40.0
1113,11,13,141,87,61.7,54,38.3
1114,11,14,53,29,54.72,24,45.28
1115,11,15,57,34,59.65,23,40.35
1116,11,16,87,60,68.97,27,31.03
1117,11,17,197,135,68.53,62,31.47
1118,11,18,104,64,61.54,40,38.46
1119,11,19,196,135,68.88,61,31.12
1120,11,20,98,68,69.39,30,30.61
1121,11,21,212,141,66.51,71,33.49
1122,11,22,157,102,64.97,55,35.03
1123,11,23,90,61,67.78,29,32.22
1124,11,24,231,158,68.4,73,31.6
1125,11,25,178,115,64.61,63,35.39
1126,11,26,164,123,75.0,41,25.0
1127,11,27,40,26,65.0,14,35.0
1128,11,28,54,27,50.0,27,50.0
1129,11,29,159,115,72.33,44,27.67
1130,11,30,75,52,69.33,23,30.67
1131,11,31,127,77,60.63,50,39.37
1132,11,32,67,45,67.16,22,32.84
1133,11,33,152,76,50.0,76,50.0
1134,11,34,56,33,58.93,23,41.07
1135,11,35,39,26,66.67,13,33.33
1136,11,36,46,33,71.74,13,28.26
1137,11,37,38,21,55.26,17,44.74
1138,11,38,74,45,60.81,29,39.19
1201,12,1,122,87,71.31,35,28.69
1202,12,2,72,42,58.33,30,41.67
1203,12,3,177,109,61.58,68,38.42
1204,12,4,134,86,64.18,48,35.82
1205,12,5,117,79,67.52,38,32.48
1206,12,6,120,66,55.0,54,45.0
1207,12,7,71,55,77.46,16,22.54
1208,12,8,121,80,66.12,41,33.88
1209,12,9,88,58,65.91,30,34.09
1210,12,10,99,57,57.58,42,42.42
1211,12,11,62,32,51.61,30,48.39
1212,12,12,75,48,64.0,27,36.0
1213,12,13,84,47,55.95,37,44.05
1214,12,14,69,41,59.42,28,40.58
1215,12,15,68,45,66.18,23,33.82
1216,12,16,37,26,70.27,11,29.73
1217,12,17,77,46,59.74,31,40.26
1218,12,18,45,24,53.33,21,46.67
1219,12,19,89,63,70.79,26,29.21
1220,12,20,83,44,53.01,39,46.99
1221,12,21,101,57,56.44,44,43.56
1222,12,22,72,42,58.33,30,41.67
1223,12,23,131,91,69.47,40,30.53
1301,13,1,97,58,59.79,39,40.21
1302,13,2,87,58,66.67,29,33.33
1303,13,3,39,30,76.92,9,23.08
1304,13,4,86,55,63.95,31,36.05
1305,13,5,60,35,58.33,25,41.67
1306,13,6,108,72,66.67,36,33.33
1307,13,7,47,32,68.09,15,31.91
1308,13,8,59,38,64.41,21,35.59
1309,13,9,64,35,54.69,29,45.31
1310,13,10,88,50,56.82,38,43.18
1311,13,11,106,62,58.49,44,41.51
1312,13,12,69,39,56.52,30,43.48
1313,13,13,83,52,62.65,31,37.35
1314,13,14,83,48,57.83,35,42.17
1315,13,15,88,61,69.32,27,30.68
1316,13,16,44,27,61.36,17,38.64
1317,13,17,87,53,60.92,34,39.08
1318,13,18,76,45,59.21,31,40.79
1319,13,19,63,30,47.62,33,52.38
1320,13,20,59,36,61.02,23,38.98
1321,13,21,119,75,63.03,44,36.97
1322,13,22,103,70,67.96,33,32.04
1323,13,23,62,37,59.68,25,40.32
1324,13,24,73,59,80.82,14,19.18
1325,13,25,58,35,60.34,23,39.66
1326,13,26,84,62,73.81,22,26.19
1327,13,27,80,51,63.75,29,36.25
1328,13,28,61,34,55.74,27,44.26
1329,13,29,51,41,80.39,10,19.61
1330,13,30,38,26,68.42,12,31.58
1331,13,31,110,77,70.0,33,30.0
1332,13,32,77,44,57.14,33,42.86
1333,13,33,103,66,64.08,37,35.92
1334,13,34,69,43,62.32,26,37.68
1335,13,35,69,48,69.57,21,30.43
1336,13,36,33,18,54.55,15,45.45
1337,13,37,140,53,37.86,87,62.14
1338,13,38,71,45,63.38,26,36.62
1339,13,39,73,56,76.71,17,23.29
1340,13,40,48,27,56.25,21,43.75
1341,13,41,83,45,54.22,38,45.78
1342,13,42,113,69,61.06,44,38.94
1343,13,43,90,56,62.22,34,37.78
1344,13,44,60,44,73.33,16,26.67
1345,13,45,82,48,58.54,34,41.46
1346,13,46,63,32,50.79,31,49.21
1347,13,47,88,57,64.77,31,35.23
1348,13,48,86,61,70.93,25,29.07
1401,14,1,134,72,53.73,62,46.27
1402,14,2,82,53,64.63,29,35.37
1403,14,3,50,28,56.0,22,44.0
1404,14,4,73,47,64.38,26,35.62
1405,14,5,64,39,60.94,25,39.06
1406,14,6,23,15,65.22,8,34.78
1407,14,7,78,42,53.85,36,46.15
1408,14,8,70,44,62.86,26,37.14
1409,14,9,86,55,63.95,31,36.05
1410,14,10,48,31,64.58,17,35.42
1411,14,11,27,13,48.15,14,51.85
1412,14,12,78,56,71.79,22,28.21
1413,14,13,69,40,57.97,29,42.03
1414,14,14,69,43,62.32,26,37.68
1415,14,15,48,28,58.33,20,41.67
1416,14,16,60,37,61.67,23,38.33
1417,14,17,35,24,68.57,11,31.43
1418,14,18,35,21,60.0,14,40.0
1419,14,19,64,34,53.13,30,46.88
1420,14,20,51,35,68.63,16,31.37
1421,14,21,41,20,48.78,21,51.22
1422,14,22,94,57,60.64,37,39.36
1423,14,23,62,35,56.45,27,43.55
1424,14,24,109,69,63.3,40,36.7
1425,14,25,34,21,61.76,13,38.24
1426,14,26,58,31,53.45,27,46.55
1427,14,27,65,36,55.38,29,44.62
1428,14,28,45,28,62.22,17,37.78
1429,14,29,50,32,64.0,18,36.0
1430,14,30,41,27,65.85,14,34.15
1431,14,31,42,25,59.52,17,40.48
1501,15,1,75,41,54.67,34,45.33
1502,15,2,57,11,19.3,46,80.7
1503,15,3,69,14,20.29,55,79.71
1504,15,4,51,34,66.67,17,33.33
1505,15,5,47,28,59.57,19,40.43
1506,15,6,54,24,44.44,30,55.56
1507,15,7,48,12,25.0,36,75.0
1508,15,8,56,31,55.36,25,44.64
1509,15,9,75,36,48.0,39,52.0
1510,15,10,116,73,62.93,43,37.07
1511,15,11,72,37,51.39,35,48.61
1512,15,12,67,37,55.22,30,44.78
1513,15,13,71,35,49.3,36,50.7
1514,15,14,45,29,64.44,16,35.56
1515,15,15,47,23,48.94,24,51.06
1516,15,16,62,26,41.94,36,58.06
1517,15,17,77,12,15.58,65,84.42
1518,15,18,51,16,31.37,35,68.63
1519,15,19,81,34,41.98,47,58.02
1520,15,20,68,17,25.0,51,75.0
1521,15,21,57,15,26.32,42,73.68
1522,15,22,71,22,30.99,49,69.01
1523,15,23,87,17,19.54,70,80.46
1524,15,24,49,13,26.53,36,73.47
1601,16,1,80,50,62.5,30,37.5
1602,16,2,79,20,25.32,59,74.68
1603,16,3,60,12,20.0,48,80.0
1604,16,4,68,11,16.18,57,83.82
1605,16,5,59,8,13.56,51,86.44
1606,16,6,75,20,26.67,55,73.33
1607,16,7,75,23,30.67,52,69.33
1608,16,8,44,14,31.82,30,68.18
1609,16,9,71,12,16.9,59,83.1
1610,16,10,80,16,20.0,64,80.0
1611,16,11,56,17,30.36,39,69.64
1612,16,12,45,15,33.33,30,66.67
1613,16,13,24,3,12.5,21,87.5
1614,16,14,57,13,22.81,44,77.19
1615,16,15,73,18,24.66,55,75.34
1616,16,16,87,20,22.99,67,77.01
1617,16,17,62,23,37.1,39,62.9
1618,16,18,67,16,23.88,51,76.12
1619,16,19,73,30,41.1,43,58.9
1620,16,20,59,19,32.2,40,67.8
1621,16,21,53,15,28.3,38,71.7
1622,16,22,52,16,30.77,36,69.23
1623,16,23,46,20,43.48,26,56.52
1624,16,24,39,14,35.9,25,64.1
1625,16,25,93,15,16.13,78,83.87
1626,16,26,54,13,24.07,41,75.93
1627,16,27,39,7,17.95,32,82.05
1628,16,28,88,10,11.36,78,88.64
1629,16,29,56,10,17.86,46,82.14
1630,16,30,58,16,27.59,42,72.41
1631,16,31,68,22,32.35,46,67.65
1632,16,32,62,27,43.55,35,56.45
1633,16,33,57,18,31.58,39,68.42
1634,16,34,73,13,17.81,60,82.19
1635,16,35,56,22,39.29,34,60.71
1636,16,36,44,3,6.82,41,93.18
1701,17,1,63,29,46.03,34,53.97
1702,17,2,100,16,16.0,84,84.0
1703,17,3,115,36,31.3,79,68.7
1704,17,4,150,33,22.0,117,78.0
1705,17,5,85,19,22.35,66,77.65
1706,17,6,76,22,28.95,54,71.05
1707,17,7,67,25,37.31,42,62.69
1708,17,8,77,15,19.48,62,80.52
1709,17,9,94,13,13.83,81,86.17
1710,17,10,129,30,23.26,99,76.74
1711,17,11,64,17,26.56,47,73.44
1712,17,12,83,29,34.94,54,65.06
1713,17,13,82,22,26.83,60,73.17
1714,17,14,65,29,44.62,36,55.38
1715,17,15,118,32,27.12,86,72.88
1716,17,16,81,20,24.69,61,75.31
1717,17,17,94,20,21.28,74,78.72
1718,17,18,152,35,23.03,117,76.97
1719,17,19,46,12,26.09,34,73.91
1720,17,20,162,35,21.6,127,78.4
1721,17,21,195,44,22.56,151,77.44
1722,17,22,109,24,22.02,85,77.98
1723,17,23,73,16,21.92,57,78.08
1724,17,24,139,25,17.99,114,82.01
1725,17,25,81,21,25.93,60,74.07
1726,17,26,120,26,21.67,94,78.33
1727,17,27,112,25,22.32,87,77.68
1728,17,28,95,19,20.0,76,80.0
1729,17,29,112,28,25.0,84,75.0
1730,17,30,43,14,32.56,29,67.44
1731,17,31,73,13,17.81,60,82.19
1732,17,32,59,20,33.9,39,66.1
1733,17,33,51,15,29.41,36,70.59
1734,17,34,59,13,22.03,46,77.97
1735,17,35,59,20,33.9,39,66.1
1736,17,36,98,28,28.57,70,71.43
1737,17,37,103,25,24.27,78,75.73
1738,17,38,104,21,20.19,83,79.81
1739,17,39,112,32,28.57,80,71.43
1740,17,40,161,41,25.47,120,74.53
1741,17,41,146,27,18.49,119,81.51
1801,18,1,93,22,23.66,71,76.34
1802,18,2,65,23,35.38,42,64.62
1803,18,3,81,39,48.15,42,51.85
1804,18,4,181,48,26.52,133,73.48
1805,18,5,71,21,29.58,50,70.42
1806,18,6,97,38,39.18,59,60.82
1807,18,7,102,33,32.35,69,67.65
1808,18,8,173,45,26.01,128,73.99
1809,18,9,186,34,18.28,152,81.72
1810,18,10,247,50,20.24,197,79.76
1811,18,11,108,43,39.81,65,60.19
1812,18,12,140,36,25.71,104,74.29
1813,18,13,117,27,23.08,90,76.92
1814,18,14,175,40,22.86,135,77.14
1815,18,15,106,41,38.68,65,61.32
1816,18,16,149,35,23.49,114,76.51
1817,18,17,103,35,33.98,68,66.02
1818,18,18,172,35,20.35,137,79.65
1819,18,19,147,27,18.37,120,81.63
1820,18,20,100,19,19.0,81,81.0
1821,18,21,197,48,24.37,149,75.63
1822,18,22,188,42,22.34,146,77.66
1823,18,23,116,30,25.86,86,74.14
1824,18,24,63,42,66.67,21,33.33
1825,18,25,88,40,45.45,48,54.55
1826,18,26,227,54,23.79,173,76.21
1827,18,27,96,27,28.13,69,71.88
1828,18,28,94,42,44.68,52,55.32
1829,18,29,133,44,33.08,89,66.92
1830,18,30,83,42,50.6,41,49.4
1831,18,31,129,37,28.68,92,71.32
1832,18,32,159,40,25.16,119,74.84
1833,18,33,87,24,27.59,63,72.41
1834,18,34,217,52,23.96,165,76.04
1835,18,35,190,47,24.74,143,75.26
1836,18,36,88,33,37.5,55,62.5
1837,18,37,197,52,26.4,145,73.6
1838,18,38,129,25,19.38,104,80.62
1839,18,39,84,23,27.38,61,72.62
1840,18,40,125,44,35.2,81,64.8
1841,18,41,207,55,26.57,152,73.43
1842,18,42,90,18,20.0,72,80.0
1843,18,43,58,31,53.45,27,46.55
1844,18,44,84,43,51.19,41,48.81
1845,18,45,85,27,31.76,58,68.24
1846,18,46,86,42,48.84,44,51.16
1847,18,47,83,28,33.73,55,66.27
1848,18,48,72,17,23.61,55,76.39
1849,18,49,70,17,24.29,53,75.71
1850,18,50,82,28,34.15,54,65.85
1901,19,1,125,83,66.4,42,33.6
1902,19,2,303,132,43.56,171,56.44
1903,19,3,66,45,68.18,21,31.82
1904,19,4,128,88,68.75,40,31.25
1905,19,5,238,117,49.16,121,50.84
1906,19,6,128,79,61.72,49,38.28
1907,19,7,140,82,58.57,58,41.43
1908,19,8,86,57,66.28,29,33.72
1909,19,9,107,67,62.62,40,37.38
1910,19,10,266,147,55.26,119,44.74
1911,19,11,105,69,65.71,36,34.29
1912,19,12,84,63,75.0,21,25.0
1913,19,13,239,65,27.2,174,72.8
1914,19,14,218,120,55.05,98,44.95
1915,19,15,123,77,62.6,46,37.4
1916,19,16,140,93,66.43,47,33.57
1917,19,17,135,82,60.74,53,39.26
1918,19,18,218,142,65.14,76,34.86
1919,19,19,312,167,53.53,145,46.47
1920,19,20,193,73,37.82,120,62.18
1921,19,21,102,67,65.69,35,34.31
1922,19,22,211,116,54.98,95,45.02
1923,19,23,164,98,59.76,66,40.24
1924,19,24,77,54,70.13,23,29.87
1925,19,25,190,122,64.21,68,35.79
1926,19,26,185,126,68.11,59,31.89
1927,19,27,195,83,42.56,112,57.44
1928,19,28,231,83,35.93,148,64.07
1929,19,29,102,60,58.82,42,41.18
1930,19,30,91,59,64.84,32,35.16
1931,19,31,165,100,60.61,65,39.39
1932,19,32,137,94,68.61,43,31.39
1933,19,33,101,67,66.34,34,33.66
1934,19,34,159,105,66.04,54,33.96
1935,19,35,192,112,58.33,80,41.67
1936,19,36,233,81,34.76,152,65.24
1937,19,37,226,120,53.1,106,46.9
1938,19,38,187,77,41.18,110,58.82
1939,19,39,40,7,17.5,33,82.5
1940,19,40,207,118,57.0,89,43.0
1941,19,41,89,67,75.28,22,24.72
1942,19,42,160,73,45.63,87,54.38
1943,19,43,231,77,33.33,154,66.67
1944,19,44,117,76,64.96,41,35.04
1945,19,45,127,82,64.57,45,35.43
1946,19,46,144,97,67.36,47,32.64
1947,19,47,320,113,35.31,207,64.69
1948,19,48,173,47,27.17,126,72.83
1949,19,49,254,99,38.98,155,61.02
1950,19,50,125,61,48.8,64,51.2
1951,19,51,188,133,70.74,55,29.26
1952,19,52,126,80,63.49,46,36.51
1953,19,53,134,82,61.19,52,38.81
1954,19,54,71,49,69.01,22,30.99
1955,19,55,77,52,67.53,25,32.47
1956,19,56,238,123,51.68,115,48.32
1957,19,57,181,105,58.01,76,41.99
2001,20,1,140,31,22.14,109,77.86
2002,20,2,25,10,40.0,15,60.0
2003,20,3,124,28,22.58,96,77.42
2004,20,4,38,10,26.32,28,73.68
2005,20,5,124,21,16.94,103,83.06
2006,20,6,39,11,28.21,28,71.79
2007,20,7,100,20,20.0,80,80.0
2008,20,8,107,14,13.08,93,86.92
2009,20,9,189,39,20.63,150,79.37
2010,20,10,70,14,20.0,56,80.0
2011,20,11,114,27,23.68,87,76.32
2012,20,12,63,13,20.63,50,79.37
2013,20,13,117,32,27.35,85,72.65
2014,20,14,90,21,23.33,69,76.67
2015,20,15,63,34,53.97,29,46.03
2016,20,16,153,38,24.84,115,75.16
2017,20,17,51,12,23.53,39,76.47
2018,20,18,85,27,31.76,58,68.24
2019,20,19,85,24,28.24,61,71.76
2020,20,20,52,30,57.69,22,42.31
2021,20,21,80,23,28.75,57,71.25
2022,20,22,208,72,34.62,136,65.38
2023,20,23,88,22,25.0,66,75.0
2024,20,24,161,69,42.86,92,57.14
2025,20,25,87,28,32.18,59,67.82
2026,20,26,144,52,36.11,92,63.89
2027,20,27,73,14,19.18,59,80.82
2028,20,28,68,16,23.53,52,76.47
2029,20,29,145,27,18.62,118,81.38
2030,20,30,55,25,45.45,30,54.55
2031,20,31,126,33,26.19,93,73.81
2032,20,32,75,26,34.67,49,65.33
2033,20,33,66,23,34.85,43,65.15
2034,20,34,144,60,41.67,84,58.33
2035,20,35,34,8,23.53,26,76.47
2036,20,36,39,11,28.21,28,71.79
2037,20,37,32,10,31.25,22,68.75
2038,20,38,26,7,26.92,19,73.08
2039,20,39,4,1,25.0,3,75.0
2101,21,1,170,54,31.76,116,68.24
2102,21,2,72,15,20.83,57,79.17
2103,21,3,177,46,25.99,131,74.01
2104,21,4,135,22,16.3,113,83.7
2105,21,5,171,41,23.98,130,76.02
2106,21,6,103,21,20.39,82,79.61
2107,21,7,181,37,20.44,144,79.56
2108,21,8,155,40,25.81,115,74.19
2109,21,9,177,34,19.21,143,80.79
2110,21,10,134,34,25.37,100,74.63
2111,21,11,132,48,36.36,84,63.64
2112,21,12,102,31,30.39,71,69.61
2113,21,13,108,23,21.3,85,78.7
2114,21,14,159,43,27.04,116,72.96
2115,21,15,117,27,23.08,90,76.92
2116,21,16,104,16,15.38,88,84.62
2117,21,17,111,29,26.13,82,73.87
2118,21,18,173,43,24.86,130,75.14
2119,21,19,158,33,20.89,125,79.11
2120,21,20,143,26,18.18,117,81.82
2121,21,21,135,28,20.74,107,79.26
2122,21,22,136,33,24.26,103,75.74
2123,21,23,146,31,21.23,115,78.77
2124,21,24,159,43,27.04,116,72.96
2125,21,25,147,32,21.77,115,78.23
2126,21,26,84,15,17.86,69,82.14
2127,21,27,152,39,25.66,113,74.34
2128,21,28,147,30,20.41,117,79.59
2129,21,29,154,39,25.32,115,74.68
2130,21,30,103,23,22.33,80,77.67
2131,21,31,144,29,20.14,115,79.86
2132,21,32,121,32,26.45,89,73.55
2133,21,33,104,19,18.27,85,81.73
2134,21,34,104,26,25.0,78,75.0
2135,21,35,167,46,27.54,121,72.46
2136,21,36,132,27,20.45,105,79.55
2137,21,37,112,28,25.0,84,75.0
2138,21,38,102,22,21.57,80,78.43
2139,21,39,78,15,19.23,63,80.77
2140,21,40,135,32,23.7,103,76.3
2141,21,41,165,48,29.09,117,70.91
2142,21,42,156,42,26.92,114,73.08
2143,21,43,141,29,20.57,112,79.43
2144,21,44,150,45,30.0,105,70.0
2145,21,45,122,26,21.31,96,78.69
2146,21,46,140,34,24.29,106,75.71
2147,21,47,104,21,20.19,83,79.81
2148,21,48,142,34,23.94,108,76.06
2149,21,49,167,47,28.14,120,71.86
2150,21,50,103,30,29.13,73,70.87
2151,21,51,162,44,27.16,118,72.84
2152,21,52,145,31,21.38,114,78.62
2153,21,53,109,33,30.28,76,69.72
2154,21,54,121,33,27.27,88,72.73
2201,22,1,57,13,22.81,44,77.19
2202,22,2,99,73,73.74,26,26.26
2203,22,3,105,72,68.57,33,31.43
2204,22,4,46,28,60.87,18,39.13
2205,22,5,71,40,56.34,31,43.66
2206,22,6,70,42,60.0,28,40.0
2207,22,7,67,37,55.22,30,44.78
2208,22,8,117,68,58.12,49,41.88
2209,22,9,59,41,69.49,18,30.51
2210,22,10,107,71,66.36,36,33.64
2211,22,11,43,29,67.44,14,32.56
2212,22,12,76,45,59.21,31,40.79
2213,22,13,61,36,59.02,25,40.98
2214,22,14,75,41,54.67,34,45.33
2215,22,15,50,30,60.0,20,40.0
2216,22,16,50,33,66.0,17,34.0
2217,22,17,93,69,74.19,24,25.81
2218,22,18,53,39,73.58,14,26.42
2219,22,19,39,19,48.72,20,51.28
2220,22,20,62,44,70.97,18,29.03
2221,22,21,90,41,45.56,49,54.44
2222,22,22,46,27,58.7,19,41.3
2223,22,23,151,51,33.77,100,66.23
2224,22,24,99,76,76.77,23,23.23
2225,22,25,62,40,64.52,22,35.48
2301,23,1,81,58,71.6,23,28.4
2302,23,2,99,53,53.54,46,46.46
2303,23,3,93,56,60.22,37,39.78
2304,23,4,85,67,78.82,18,21.18
2305,23,5,58,37,63.79,21,36.21
2306,23,6,67,40,59.7,27,40.3
2307,23,7,51,37,72.55,14,27.45
2308,23,8,87,50,57.47,37,42.53
2309,23,9,39,26,66.67,13,33.33
2310,23,10,81,57,70.37,24,29.63
2311,23,11,65,38,58.46,27,41.54
2312,23,12,93,62,66.67,31,33.33
2313,23,13,54,36,66.67,18,33.33
2314,23,14,72,47,65.28,25,34.72
2315,23,15,51,22,43.14,29,56.86
2316,23,16,118,78,66.1,40,33.9
2317,23,17,34,18,52.94,16,47.06
2318,23,18,84,55,65.48,29,34.52
2319,23,19,46,29,63.04,17,36.96
2320,23,20,38,23,60.53,15,39.47
2321,23,21,104,74,71.15,30,28.85
2322,23,22,73,54,73.97,19,26.03
2323,23,23,106,69,65.09,37,34.91
2324,23,24,60,36,60.0,24,40.0
2325,23,25,57,24,42.11,33,57.89
2326,23,26,75,43,57.33,32,42.67
2327,23,27,91,49,53.85,42,46.15
2328,23,28,73,40,54.79,33,45.21
2329,23,29,67,37,55.22,30,44.78
2330,23,30,74,42,56.76,32,43.24
2331,23,31,46,35,76.09,11,23.91
2332,23,32,62,40,64.52,22,35.48
2333,23,33,63,29,46.03,34,53.97
2334,23,34,60,42,70.0,18,30.0
2335,23,35,55,34,61.82,21,38.18
2336,23,36,93,58,62.37,35,37.63
2337,23,37,124,73,58.87,51,41.13
2338,23,38,82,58,70.73,24,29.27
2339,23,39,85,64,75.29,21,24.71
2401,24,1,85,14,16.47,71,83.53
2402,24,2,68,17,25.0,51,75.0
2403,24,3,77,21,27.27,56,72.73
2404,24,4,49,12,24.49,37,75.51
2405,24,5,31,10,32.26,21,67.74
2406,24,6,89,18,20.22,71,79.78
2407,24,7,51,36,70.59,15,29.41
2408,24,8,28,8,28.57,20,71.43
2409,24,9,80,22,27.5,58,72.5
2410,24,10,63,21,33.33,42,66.67
2411,24,11,67,20,29.85,47,70.15
2412,24,12,46,11,23.91,35,76.09
2413,24,13,43,11,25.58,32,74.42
2414,24,14,49,10,20.41,39,79.59
2415,24,15,33,11,33.33,22,66.67
2416,24,16,400,129,32.25,271,67.75
2417,24,17,62,17,27.42,45,72.58
2418,24,18,90,29,32.22,61,67.78
2419,24,19,92,25,27.17,67,72.83
2420,24,20,70,13,18.57,57,81.43
2421,24,21,41,9,21.95,32,78.05
2422,24,22,111,31,27.93,80,72.07
2423,24,23,75,18,24.0,57,76.0
2424,24,24,84,20,23.81,64,76.19
2425,24,25,44,8,18.18,36,81.82
2426,24,26,172,40,23.26,132,76.74
2427,24,27,101,33,32.67,68,67.33
2428,24,28,45,10,22.22,35,77.78
2429,24,29,28,9,32.14,19,67.86
2430,24,30,49,9,18.37,40,81.63
2431,24,31,77,14,18.18,63,81.82
2432,24,32,53,19,35.85,34,64.15
2433,24,33,43,6,13.95,37,86.05
2434,24,34,65,22,33.85,43,66.15
2435,24,35,73,20,27.4,53,72.6
2436,24,36,130,28,21.54,102,78.46
2437,24,37,53,10,18.87,43,81.13
2438,24,38,86,30,34.88,56,65.12
2439,24,39,112,43,38.39,69,61.61
2440,24,40,83,18,21.69,65,78.31
2441,24,41,74,24,32.43,50,67.57
2501,25,1,99,68,68.69,31,31.31
2502,25,2,151,86,56.95,65,43.05
2503,25,3,179,94,52.51,85,47.49
2504,25,4,94,42,44.68,52,55.32
2505,25,5,118,80,67.8,38,32.2
2506,25,6,42,30,71.43,12,28.57
2507,25,7,115,65,56.52,50,43.48
2508,25,8,130,83,63.85,47,36.15
2509,25,9,94,64,68.09,30,31.91
2510,25,10,152,89,58.55,63,41.45
2511,25,11,134,87,64.93,47,35.07
2512,25,12,137,92,67.15,45,32.85
2513,25,13,177,113,63.84,64,36.16
2514,25,14,95,65,68.42,30,31.58
2515,25,15,107,69,64.49,38,35.51
2516,25,16,169,99,58.58,70,41.42
2517,25,17,158,90,56.96,68,43.04
2518,25,18,63,45,71.43,18,28.57
2519,25,19,123,74,60.16,49,39.84
2520,25,20,62,22,35.48,40,64.52
2521,25,21,296,146,49.32,150,50.68
2522,25,22,112,79,70.54,33,29.46
2523,25,23,167,104,62.28,63,37.72
2524,25,24,100,69,69.0,31,31.0
2525,25,25,117,80,68.38,37,31.62
2526,25,26,113,75,66.37,38,33.63
2527,25,27,158,84,53.16,74,46.84
2528,25,28,122,77,63.11,45,36.89
2529,25,29,114,52,45.61,62,54.39
2530,25,30,105,68,64.76,37,35.24
2531,25,31,185,114,61.62,71,38.38
2532,25,32,91,55,60.44,36,39.56
2601,26,1,127,83,65.35,44,34.65
2602,26,2,95,64,67.37,31,32.63
2603,26,3,143,93,65.03,50,34.97
2604,26,4,53,26,49.06,27,50.94
2605,26,5,99,56,56.57,43,43.43
2606,26,6,77,51,66.23,26,33.77
2607,26,7,97,75,77.32,22,22.68
2608,26,8,48,27,56.25,21,43.75
2609,26,9,104,63,60.58,41,39.42
2610,26,10,95,61,64.21,34,35.79
2611,26,11,104,61,58.65,43,41.35
2612,26,12,128,78,60.94,50,39.06
2613,26,13,41,23,56.1,18,43.9
2614,26,14,84,46,54.76,38,45.24
2615,26,15,46,20,43.48,26,56.52
2616,26,16,36,21,58.33,15,41.67
2617,26,17,126,79,62.7,47,37.3
2618,26,18,63,35,55.56,28,44.44
2619,26,19,45,17,37.78,28,62.22
2620,26,20,113,66,58.41,47,41.59
2621,26,21,127,83,65.35,44,34.65
2622,26,22,23,14,60.87,9,39.13
2623,26,23,54,33,61.11,21,38.89
2624,26,24,78,50,64.1,28,35.9
2625,26,25,89,50,56.18,39,43.82
2626,26,26,76,49,64.47,27,35.53
2627,26,27,142,79,55.63,63,44.37
2628,26,28,159,98,61.64,61,38.36
2629,26,29,72,45,62.5,27,37.5
2630,26,30,109,65,59.63,44,40.37
2631,26,31,55,33,60.0,22,40.0
2632,26,32,114,63,55.26,51,44.74
2633,26,33,135,80,59.26,55,40.74
2634,26,34,138,103,74.64,35,25.36
2635,26,35,82,45,54.88,37,45.12
2636,26,36,120,65,54.17,55,45.83
2637,26,37,119,80,67.23,39,32.77
2638,26,38,42,20,47.62,22,52.38
2639,26,39,129,92,71.32,37,28.68
2640,26,40,53,29,54.72,24,45.28
2641,26,41,133,86,64.66,47,35.34
2642,26,42,104,71,68.27,33,31.73
2643,26,43,50,33,66.0,17,34.0
2644,26,44,45,23,51.11,22,48.89
2645,26,45,39,28,71.79,11,28.21
2646,26,46,98,62,63.27,36,36.73
2647,26,47,46,29,63.04,17,36.96
2648,26,48,130,80,61.54,50,38.46
2649,26,49,44,23,52.27,21,47.73
2701,27,1,210,117,55.71,93,44.29
2702,27,2,156,68,43.59,88,56.41
2703,27,3,57,16,28.07,41,71.93
2704,27,4,73,22,30.14,51,69.86
2705,27,5,74,19,25.68,55,74.32
2706,27,6,123,52,42.28,71,57.72
2707,27,7,158,101,63.92,57,36.08
2708,27,8,71,21,29.58,50,70.42
2709,27,9,59,30,50.85,29,49.15
2710,27,10,130,21,16.15,109,83.85
2711,27,11,97,55,56.7,42,43.3
2712,27,12,88,52,59.09,36,40.91
2713,27,13,201,73,36.32,128,63.68
2714,27,14,52,10,19.23,42,80.77
2715,27,15,47,20,42.55,27,57.45
2716,27,16,97,55,56.7,42,43.3
2717,27,17,106,36,33.96,70,66.04
2718,27,18,73,21,28.77,52,71.23
2719,27,19,53,22,41.51,31,58.49
2720,27,20,46,11,23.91,35,76.09
2721,27,21,137,68,49.64,69,50.36
2722,27,22,63,20,31.75,43,68.25
2723,27,23,81,25,30.86,56,69.14
2724,27,24,54,22,40.74,32,59.26
2725,27,25,113,53,46.9,60,53.1
2726,27,26,81,26,32.1,55,67.9
2727,27,27,146,49,33.56,97,66.44
2728,27,28,155,69,44.52,86,55.48
2729,27,29,71,29,40.85,42,59.15
2730,27,30,41,10,24.39,31,75.61
2731,27,31,61,17,27.87,44,72.13
2732,27,32,111,34,30.63,77,69.37
2733,27,33,126,48,38.1,78,61.9
2734,27,34,61,13,21.31,48,78.69
2735,27,35,161,94,58.39,67,41.61
2736,27,36,76,35,46.05,41,53.95
2737,27,37,136,49,36.03,87,63.97
2738,27,38,214,83,38.79,131,61.21
2739,27,39,99,28,28.28,71,71.72
2740,27,40,123,52,42.28,71,57.72
2741,27,41,113,27,23.89,86,76.11
2742,27,42,105,39,37.14,66,62.86
2743,27,43,77,23,29.87,54,70.13
2744,27,44,63,25,39.68,38,60.32
2745,27,45,241,120,49.79,121,50.21
2746,27,46,104,67,64.42,37,35.58
2747,27,47,103,30,29.13,73,70.87
2748,27,48,181,65,35.91,116,64.09
2749,27,49,93,39,41.94,54,58.06
2750,27,50,99,17,17.17,82,82.83
2801,28,1,41,8,19.51,33,80.49
2802,28,2,79,29,36.71,50,63.29
2803,28,3,50,8,16.0,42,84.0
2804,28,4,68,30,44.12,38,55.88
2805,28,5,58,20,34.48,38,65.52
2806,28,6,59,31,52.54,28,47.46
2807,28,7,57,7,12.28,50,87.72
2808,28,8,132,64,48.48,68,51.52
2809,28,9,63,11,17.46,52,82.54
2810,28,10,121,61,50.41,60,49.59
2811,28,11,168,82,48.81,86,51.19
2812,28,12,70,10,14.29,60,85.71
2813,28,13,144,29,20.14,115,79.86
2814,28,14,62,14,22.58,48,77.42
2815,28,15,37,9,24.32,28,75.68
2816,28,16,50,15,30.0,35,70.0
2817,28,17,74,10,13.51,64,86.49
2818,28,18,73,13,17.81,60,82.19
2819,28,19,76,44,57.89,32,42.11
2820,28,20,56,13,23.21,43,76.79
2821,28,21,77,10,12.99,67,87.01
2822,28,22,93,42,45.16,51,54.84
2823,28,23,84,24,28.57,60,71.43
2824,28,24,60,11,18.33,49,81.67
2825,28,25,146,31,21.23,115,78.77
2826,28,26,89,24,26.97,65,73.03
2827,28,27,102,58,56.86,44,43.14
2828,28,28,133,85,63.91,48,36.09
2829,28,29,27,4,14.81,23,85.19
2830,28,30,23,5,21.74,18,78.26
2831,28,31,124,34,27.42,90,72.58
2832,28,32,82,14,17.07,68,82.93
2833,28,33,99,19,19.19,80,80.81
2834,28,34,103,29,28.16,74,71.84
2835,28,35,62,16,25.81,46,74.19
2836,28,36,46,3,6.52,43,93.48
2837,28,37,82,21,25.61,61,74.39
2838,28,38,32,11,34.38,21,65.63
2839,28,39,48,10,20.83,38,79.17
2840,28,40,107,31,28.97,76,71.03
2841,28,41,67,14,20.9,53,79.1
2842,28,42,65,10,15.38,55,84.62
2843,28,43,98,17,17.35,81,82.65
2844,28,44,52,12,23.08,40,76.92
2845,28,45,132,68,51.52,64,48.48
2846,28,46,208,106,50.96,102,49.04
2901,29,1,222,136,61.26,86,38.74
2902,29,2,141,37,26.24,104,73.76
2903,29,3,121,41,33.88,80,66.12
2904,29,4,146,42,28.77,104,71.23
2905,29,5,61,20,32.79,41,67.21
2906,29,6,78,21,26.92,57,73.08
2907,29,7,162,64,39.51,98,60.49
2908,29,8,66,16,24.24,50,75.76
2909,29,9,192,95,49.48,97,50.52
2910,29,10,231,114,49.35,117,50.65
2911,29,11,88,19,21.59,69,78.41
2912,29,12,156,63,40.38,93,59.62
2913,29,13,139,39,28.06,100,71.94
2914,29,14,116,31,26.72,85,73.28
2915,29,15,155,36,23.23,119,76.77
2916,29,16,100,18,18.0,82,82.0
2917,29,17,99,22,22.22,77,77.78
2918,29,18,110,36,32.73,74,67.27
2919,29,19,157,49,31.21,108,68.79
2920,29,20,112,31,27.68,81,72.32
2921,29,21,117,30,25.64,87,74.36
2922,29,22,113,28,24.78,85,75.22
2923,29,23,129,68,52.71,61,47.29
2924,29,24,110,30,27.27,80,72.73
2925,29,25,168,40,23.81,128,76.19
2926,29,26,125,44,35.2,81,64.8
2927,29,27,110,37,33.64,73,66.36
2928,29,28,146,39,26.71,107,73.29
2929,29,29,126,64,50.79,62,49.21
2930,29,30,201,95,47.26,106,52.74
2931,29,31,94,57,60.64,37,39.36
2932,29,32,104,59,56.73,45,43.27
2933,29,33,103,22,21.36,81,78.64
2934,29,34,81,35,43.21,46,56.79
2935,29,35,77,17,22.08,60,77.92
2936,29,36,114,40,35.09,74,64.91
2937,29,37,92,23,25.0,69,75.0
2938,29,38,102,61,59.8,41,40.2
2939,29,39,94,50,53.19,44,46.81
2940,29,40,155,34,21.94,121,78.06
2941,29,41,90,24,26.67,66,73.33
2942,29,42,121,29,23.97,92,76.03
2943,29,43,212,101,47.64,111,52.36
2944,29,44,152,40,26.32,112,73.68
3001,30,1,165,90,54.55,75,45.45
3002,30,2,101,52,51.49,49,48.51
3003,30,3,146,94,64.38,52,35.62
3004,30,4,111,72,64.86,39,35.14
3005,30,5,55,27,49.09,28,50.91
3006,30,6,90,46,51.11,44,48.89
3007,30,7,146,92,63.01,54,36.99
3008,30,8,185,117,63.24,68,36.76
3009,30,9,94,63,67.02,31,32.98
3010,30,10,109,54,49.54,55,50.46
3011,30,11,75,36,48.0,39,52.0
3012,30,12,67,38,56.72,29,43.28
3013,30,13,105,60,57.14,45,42.86
3014,30,14,54,26,48.15,28,51.85
3015,30,15,187,140,74.87,47,25.13
3016,30,16,50,27,54.0,23,46.0
3017,30,17,113,56,49.56,57,50.44
3018,30,18,185,135,72.97,50,27.03
3019,30,19,73,45,61.64,28,38.36
3020,30,20,147,93,63.27,54,36.73
3021,30,21,83,38,45.78,45,54.22
3022,30,22,209,139,66.51,70,33.49
3023,30,23,137,82,59.85,55,40.15
3024,30,24,210,143,68.1,67,31.9
3025,30,25,209,138,66.03,71,33.97
3026,30,26,77,52,67.53,25,32.47
3027,30,27,86,49,56.98,37,43.02
3028,30,28,178,118,66.29,60,33.71
3029,30,29,56,30,53.57,26,46.43
3030,30,30,44,26,59.09,18,40.91
3031,30,31,60,36,60.0,24,40.0
3032,30,32,138,77,55.8,61,44.2
3101,31,1,55,30,54.55,25,45.45
3102,31,2,48,25,52.08,23,47.92
3103,31,3,49,36,73.47,13,26.53
3104,31,4,118,81,68.64,37,31.36
3105,31,5,90,45,50.0,45,50.0
3106,31,6,56,26,46.43,30,53.57
3107,31,7,168,120,71.43,48,28.57
3108,31,8,54,22,40.74,32,59.26
3109,31,9,59,34,57.63,25,42.37
3110,31,10,89,49,55.06,40,44.94
3111,31,11,68,43,63.24,25,36.76
3112,31,12,77,38,49.35,39,50.65
3113,31,13,74,47,63.51,27,36.49
3114,31,14,70,44,62.86,26,37.14
3115,31,15,60,37,61.67,23,38.33
3116,31,16,128,83,64.84,45,35.16
3117,31,17,59,35,59.32,24,40.68
3118,31,18,78,51,65.38,27,34.62
3119,31,19,64,30,46.88,34,53.13
3120,31,20,57,25,43.86,32,56.14
3121,31,21,51,29,56.86,22,43.14
3122,31,22,53,32,60.38,21,39.62
3123,31,23,87,53,60.92,34,39.08
3124,31,24,93,56,60.22,37,39.78
3125,31,25,53,23,43.4,30,56.6
3126,31,26,98,61,62.24,37,37.76
3127,31,27,73,41,56.16,32,43.84
3128,31,28,39,27,69.23,12,30.77
3129,31,29,60,35,58.33,25,41.67
3130,31,30,57,36,63.16,21,36.84
3131,31,31,53,36,67.92,17,32.08
3132,31,32,30,19,63.33,11,36.67
3133,31,33,64,40,62.5,24,37.5
3134,31,34,91,56,61.54,35,38.46
3135,31,35,66,36,54.55,30,45.45
3136,31,36,66,44,66.67,22,33.33
3137,31,37,53,32,60.38,21,39.62
3138,31,38,38,23,60.53,15,39.47
3139,31,39,74,50,67.57,24,32.43
3140,31,40,85,52,61.18,33,38.82
3141,31,41,68,43,63.24,25,36.76
3201,32,1,182,116,63.74,66,36.26
3202,32,2,165,101,61.21,64,38.79
3203,32,3,203,139,68.47,64,31.53
3204,32,4,171,112,65.5,59,34.5
3205,32,5,169,113,66.86,56,33.14
3206,32,6,197,130,65.99,67,34.01
3207,32,7,176,109,61.93,67,38.07
3208,32,8,176,119,67.61,57,32.39
3209,32,9,158,88,55.7,70,44.3
3210,32,10,165,106,64.24,59,35.76
3211,32,11,179,129,72.07,50,27.93
3212,32,12,158,120,75.95,38,24.05
3213,32,13,158,88,55.7,70,44.3
3214,32,14,220,154,70.0,66,30.0
3215,32,15,164,117,71.34,47,28.66
3216,32,16,171,123,71.93,48,28.07
3217,32,17,202,148,73.27,54,26.73
3218,32,18,145,84,57.93,61,42.07
3219,32,19,158,94,59.49,64,40.51
3220,32,20,191,135,70.68,56,29.32
3221,32,21,208,157,75.48,51,24.52
3222,32,22,287,216,75.26,71,24.74
3223,32,23,160,106,66.25,54,33.75
3224,32,24,128,89,69.53,39,30.47
3225,32,25,180,119,66.11,61,33.89
3226,32,26,241,169,70.12,72,29.88
3227,32,27,128,85,66.41,43,33.59
3228,32,28,208,157,75.48,51,24.52
3229,32,29,166,105,63.25,61,36.75
3230,32,30,129,84,65.12,45,34.88
3231,32,31,155,99,63.87,56,36.13
3232,32,32,198,128,64.65,70,35.35
3233,32,33,174,103,59.2,71,40.8
3234,32,34,171,109,63.74,62,36.26
3235,32,35,155,96,61.94,59,38.06
3236,32,36,160,112,70.0,48,30.0
3237,32,37,171,103,60.23,68,39.77
3238,32,38,157,107,68.15,50,31.85
3239,32,39,164,121,73.78,43,26.22
3240,32,40,171,114,66.67,57,33.33
3241,32,41,176,108,61.36,68,38.64
3242,32,42,142,97,68.31,45,31.69
3243,32,43,227,146,64.32,81,35.68
3301,33,1,211,134,63.51,77,36.49
3302,33,2,243,172,70.78,71,29.22
3303,33,3,280,180,64.29,100,35.71
3304,33,4,254,157,61.81,97,38.19
3305,33,5,151,91,60.26,60,39.74
3306,33,6,141,78,55.32,63,44.68
3307,33,7,213,154,72.3,59,27.7
3308,33,8,331,224,67.67,107,32.33
3309,33,9,217,125,57.6,92,42.4
3310,33,10,153,108,70.59,45,29.41
3311,33,11,223,144,64.57,79,35.43
3312,33,12,169,105,62.13,64,37.87
3313,33,13,180,120,66.67,60,33.33
3314,33,14,98,66,67.35,32,32.65
3315,33,15,226,145,64.16,81,35.84
3316,33,16,245,165,67.35,80,32.65
3317,33,17,210,119,56.67,91,43.33
3318,33,18,242,157,64.88,85,35.12
3319,33,19,187,117,62.57,70,37.43
3320,33,20,283,210,74.2,73,25.8
3321,33,21,215,154,71.63,61,28.37
3322,33,22,187,115,61.5,72,38.5
3323,33,23,252,170,67.46,82,32.54
3324,33,24,347,253,72.91,94,27.09
3325,33,25,241,155,64.32,86,35.68
3326,33,26,150,102,68.0,48,32.0
3327,33,27,190,117,61.58,73,38.42
3328,33,28,176,133,75.57,43,24.43
3401,34,1,181,55,30.39,126,69.61
3402,34,2,143,41,28.67,102,71.33
3403,34,3,144,52,36.11,92,63.89
3404,34,4,91,17,18.68,74,81.32
3405,34,5,114,36,31.58,78,68.42
3406,34,6,161,59,36.65,102,63.35
3407,34,7,182,56,30.77,126,69.23
3408,34,8,97,26,26.8,71,73.2
3409,34,9,87,28,32.18,59,67.82
3410,34,10,160,61,38.13,99,61.88
3411,34,11,79,28,35.44,51,64.56
3412,34,12,182,57,31.32,125,68.68
3413,34,13,127,35,27.56,92,72.44
3414,34,14,102,25,24.51,77,75.49
3415,34,15,113,33,29.2,80,70.8
3416,34,16,113,36,31.86,77,68.14
3417,34,17,188,58,30.85,130,69.15
3418,34,18,70,19,27.14,51,72.86
3419,34,19,138,47,34.06,91,65.94
3420,34,20,204,66,32.35,138,67.65
3421,34,21,229,68,29.69,161,70.31
3422,34,22,155,58,37.42,97,62.58
3423,34,23,108,31,28.7,77,71.3
3424,34,24,102,23,22.55,79,77.45
3425,34,25,230,54,23.48,176,76.52
3426,34,26,161,55,34.16,106,65.84
3427,34,27,82,16,19.51,66,80.49
3428,34,28,51,10,19.61,41,80.39
3429,34,29,108,29,26.85,79,73.15
3430,34,30,197,53,26.9,144,73.1
3431,34,31,83,27,32.53,56,67.47
3432,34,32,116,47,40.52,69,59.48
3433,34,33,93,21,22.58,72,77.42
3434,34,34,164,57,34.76,107,65.24
3435,34,35,182,47,25.82,135,74.18
3436,34,36,141,44,31.21,97,68.79
3437,34,37,44,12,27.27,32,72.73
3438,34,38,49,15,30.61,34,69.39
3439,34,39,68,22,32.35,46,67.65
3440,34,40,134,36,26.87,98,73.13
3441,34,41,73,23,31.51,50,68.49
3442,34,42,151,41,27.15,110,72.85
3443,34,43,163,54,33.13,109,66.87
3444,34,44,151,49,32.45,102,67.55
3445,34,45,149,42,28.19,107,71.81
3446,34,46,123,42,34.15,81,65.85
3447,34,47,101,29,28.71,72,71.29
3448,34,48,179,54,30.17,125,69.83
3449,34,49,169,54,31.95,115,68.05
3450,34,50,103,27,26.21,76,73.79
3451,34,51,178,64,35.96,114,64.04
3452,34,52,131,46,35.11,85,64.89
3453,34,53,78,29,37.18,49,62.82
3501,35,1,196,139,70.92,57,29.08
3502,35,2,220,162,73.64,58,26.36
3503,35,3,135,87,64.44,48,35.56
3504,35,4,175,120,68.57,55,31.43
3505,35,5,145,96,66.21,49,33.79
3506,35,6,146,111,76.03,35,23.97
3507,35,7,204,141,69.12,63,30.88
3508,35,8,176,121,68.75,55,31.25
3509,35,9,125,84,67.2,41,32.8
3510,35,10,210,151,71.9,59,28.1
3511,35,11,201,149,74.13,52,25.87
3512,35,12,71,37,52.11,34,47.89
3513,35,13,74,34,45.95,40,54.05
3514,35,14,104,56,53.85,48,46.15
3515,35,15,205,137,66.83,68,33.17
3516,35,16,40,27,67.5,13,32.5
3517,35,17,188,126,67.02,62,32.98
3518,35,18,84,43,51.19,41,48.81
3519,35,19,58,26,44.83,32,55.17
3520,35,20,129,81,62.79,48,37.21
3521,35,21,167,102,61.08,65,38.92
3522,35,22,185,135,72.97,50,27.03
3523,35,23,175,96,54.86,79,45.14
3524,35,24,143,92,64.34,51,35.66
3525,35,25,161,116,72.05,45,27.95
3526,35,26,111,76,68.47,35,31.53
3527,35,27,145,89,61.38,56,38.62
3528,35,28,191,134,70.16,57,29.84
3529,35,29,113,61,53.98,52,46.02
3530,35,30,115,65,56.52,50,43.48
3531,35,31,181,121,66.85,60,33.15
3601,36,1,91,42,46.15,49,53.85
3602,36,2,81,31,38.27,50,61.73
3603,36,3,87,52,59.77,35,40.23
3604,36,4,73,37,50.68,36,49.32
3605,36,5,78,26,33.33,52,66.67
3606,36,6,65,37,56.92,28,43.08
3607,36,7,145,91,62.76,54,37.24
3608,36,8,54,25,46.3,29,53.7
3609,36,9,68,36,52.94,32,47.06
3610,36,10,100,59,59.0,41,41.0
3611,36,11,61,33,54.1,28,45.9
3612,36,12,57,35,61.4,22,38.6
3613,36,13,68,37,54.41,31,45.59
3614,36,14,148,88,59.46,60,40.54
3615,36,15,121,83,68.6,38,31.4
3616,36,16,125,83,66.4,42,33.6
3617,36,17,152,92,60.53,60,39.47
3618,36,18,145,93,64.14,52,35.86
3619,36,19,113,63,55.75,50,44.25
3620,36,20,118,69,58.47,49,41.53
3621,36,21,70,30,42.86,40,57.14
3622,36,22,52,34,65.38,18,34.62
3623,36,23,45,16,35.56,29,64.44
3624,36,24,105,55,52.38,50,47.62
3625,36,25,76,37,48.68,39,51.32
3626,36,26,91,64,70.33,27,29.67
3627,36,27,96,61,63.54,35,36.46
3628,36,28,90,47,52.22,43,47.78
3629,36,29,119,69,57.98,50,42.02
3630,36,30,113,71,62.83,42,37.17
3701,37,1,112,46,41.07,66,58.93
3702,37,2,63,27,42.86,36,57.14
3703,37,3,54,19,35.19,35,64.81
3704,37,4,65,21,32.31,44,67.69
3705,37,5,128,41,32.03,87,67.97
3706,37,6,102,24,23.53,78,76.47
3707,37,7,72,37,51.39,35,48.61
3708,37,8,54,24,44.44,30,55.56
3709,37,9,84,19,22.62,65,77.38
3710,37,10,118,41,34.75,77,65.25
3711,37,11,55,19,34.55,36,65.45
3712,37,12,67,29,43.28,38,56.72
3713,37,13,64,30,46.88,34,53.13
3714,37,14,108,27,25.0,81,75.0
3715,37,15,90,22,24.44,68,75.56
3716,37,16,119,40,33.61,79,66.39
3717,37,17,66,23,34.85,43,65.15
3718,37,18,86,26,30.23,60,69.77
3719,37,19,72,17,23.61,55,76.39
3720,37,20,66,15,22.73,51,77.27
3721,37,21,62,29,46.77,33,53.23
3722,37,22,67,20,29.85,47,70.15
3723,37,23,98,27,27.55,71,72.45
3724,37,24,113,38,33.63,75,66.37
3725,37,25,90,23,25.56,67,74.44
3726,37,26,143,36,25.17,107,74.83
3727,37,27,91,24,26.37,67,73.63
3728,37,28,78,30,38.46,48,61.54
3729,37,29,79,19,24.05,60,75.95
3730,37,30,75,15,20.0,60,80.0
3731,37,31,115,31,26.96,84,73.04
3732,37,32,104,29,27.88,75,72.12
3733,37,33,112,31,27.68,81,72.32
3734,37,34,94,24,25.53,70,74.47
3735,37,35,131,38,29.01,93,70.99
3736,37,36,72,22,30.56,50,69.44
3737,37,37,79,22,27.85,57,72.15
3738,37,38,137,52,37.96,85,62.04
3739,37,39,85,20,23.53,65,76.47
3740,37,40,111,29,26.13,82,73.87
3741,37,41,116,34,29.31,82,70.69
3801,38,1,134,83,61.94,51,38.06
3802,38,2,130,88,67.69,42,32.31
3803,38,3,100,69,69.0,31,31.0
3804,38,4,114,63,55.26,51,44.74
3805,38,5,99,61,61.62,38,38.38
3806,38,6,87,53,60.92,34,39.08
3807,38,7,111,65,58.56,46,41.44
3808,38,8,91,61,67.03,30,32.97
3809,38,9,143,88,61.54,55,38.46
3810,38,10,100,60,60.0,40,40.0
3811,38,11,119,72,60.5,47,39.5
3812,38,12,107,69,64.49,38,35.51
3813,38,13,124,84,67.74,40,32.26
3814,38,14,144,91,63.19,53,36.81
3815,38,15,118,73,61.86,45,38.14
3816,38,16,102,63,61.76,39,38.24
3817,38,17,128,78,60.94,50,39.06
3818,38,18,132,83,62.88,49,37.12
3819,38,19,165,106,64.24,59,35.76
3820,38,20,115,62,53.91,53,46.09
3821,38,21,129,78,60.47,51,39.53
3822,38,22,140,95,67.86,45,32.14
3823,38,23,145,99,68.28,46,31.72
3824,38,24,115,72,62.61,43,37.39
3825,38,25,114,71,62.28,43,37.72
3826,38,26,137,82,59.85,55,40.15
3827,38,27,101,45,44.55,56,55.45
3828,38,28,115,71,61.74,44,38.26
3829,38,29,134,90,67.16,44,32.84
3830,38,30,102,73,71.57,29,28.43
3831,38,31,184,114,61.96,70,38.04
3832,38,32,122,83,68.03,39,31.97
3833,38,33,100,59,59.0,41,41.0
3834,38,34,142,91,64.08,51,35.92
3835,38,35,124,62,50.0,62,50.0
3836,38,36,127,79,62.2,48,37.8
3837,38,37,128,80,62.5,48,37.5
3838,38,38,116,76,65.52,40,34.48
3839,38,39,163,105,64.42,58,35.58
3840,38,40,160,104,65.0,56,35.0
3841,38,41,195,130,66.67,65,33.33
3901,39,1,149,96,64.43,53,35.57
3902,39,2,140,84,60.0,56,40.0
3903,39,3,197,139,70.56,58,29.44
3904,39,4,157,111,70.7,46,29.3
3905,39,5,178,114,64.04,64,35.96
3906,39,6,147,97,65.99,50,34.01
3907,39,7,154,104,67.53,50,32.47
3908,39,8,190,110,57.89,80,42.11
3909,39,9,124,67,54.03,57,45.97
3910,39,10,98,63,64.29,35,35.71
3911,39,11,153,106,69.28,47,30.72
3912,39,12,195,140,71.79,55,28.21
3913,39,13,120,87,72.5,33,27.5
3914,39,14,168,117,69.64,51,30.36
3915,39,15,163,94,57.67,69,42.33
3916,39,16,89,53,59.55,36,40.45
3917,39,17,225,162,72.0,63,28.0
3918,39,18,168,114,67.86,54,32.14
3919,39,19,181,106,58.56,75,41.44
3920,39,20,188,114,60.64,74,39.36
3921,39,21,143,79,55.24,64,44.76
3922,39,22,104,67,64.42,37,35.58
3923,39,23,153,120,78.43,33,21.57
3924,39,24,206,127,61.65,79,38.35
3925,39,25,94,60,63.83,34,36.17
3926,39,26,129,81,62.79,48,37.21
3927,39,27,40,29,72.5,11,27.5
3928,39,28,243,157,64.61,86,35.39
3929,39,29,72,43,59.72,29,40.28
3930,39,30,177,110,62.15,67,37.85
3931,39,31,108,66,61.11,42,38.89
3932,39,32,136,85,62.5,51,37.5
3933,39,33,153,110,71.9,43,28.1
3934,39,34,147,91,61.9,56,38.1
3935,39,35,175,130,74.29,45,25.71
3936,39,36,48,23,47.92,25,52.08
3937,39,37,190,123,64.74,67,35.26
3938,39,38,144,104,72.22,40,27.78
3939,39,39,99,62,62.63,37,37.37
3940,39,40,145,89,61.38,56,38.62
3941,39,41,191,138,72.25,53,27.75
3942,39,42,194,116,59.79,78,40.21
3943,39,43,156,106,67.95,50,32.05
3944,39,44,126,91,72.22,35,27.78
3945,39,45,172,108,62.79,64,37.21
4001,40,1,126,87,69.05,39,30.95
4002,40,2,173,113,65.32,60,34.68
4003,40,3,260,192,73.85,68,26.15
4004,40,4,105,76,72.38,29,27.62
4005,40,5,231,170,73.59,61,26.41
4006,40,6,263,187,71.1,76,28.9
4007,40,7,236,184,77.97,52,22.03
4008,40,8,344,232,67.44,112,32.56
4009,40,9,116,60,51.72,56,48.28
4010,40,10,133,85,63.91,48,36.09
4011,40,11,231,172,74.46,59,25.54
4012,40,12,183,128,69.95,55,30.05
4013,40,13,334,235,70.36,99,29.64
4014,40,14,141,94,66.67,47,33.33
4015,40,15,140,88,62.86,52,37.14
4016,40,16,315,226,71.75,89,28.25
4017,40,17,194,136,70.1,58,29.9
4018,40,18,110,68,61.82,42,38.18
4019,40,19,193,119,61.66,74,38.34
4020,40,20,147,98,66.67,49,33.33
4021,40,21,290,217,74.83,73,25.17
4022,40,22,292,214,73.29,78,26.71
4023,40,23,333,217,65.17,116,34.83
4024,40,24,129,90,69.77,39,30.23
4025,40,25,299,210,70.23,89,29.77
4026,40,26,249,181,72.69,68,27.31
4027,40,27,225,154,68.44,71,31.56
4028,40,28,215,157,73.02,58,26.98
4029,40,29,202,147,72.77,55,27.23
4030,40,30,170,125,73.53,45,26.47
4031,40,31,291,206,70.79,85,29.21
4032,40,32,245,182,74.29,63,25.71
4033,40,33,268,211,78.73,57,21.27
4034,40,34,153,112,73.2,41,26.8
4035,40,35,81,52,64.2,29,35.8
4036,40,36,178,124,69.66,54,30.34
4037,40,37,173,142,82.08,31,17.92
4038,40,38,263,190,72.24,73,27.76
4039,40,39,37,27,72.97,10,27.03
4101,41,1,128,70,54.69,58,45.31
4102,41,2,142,85,59.86,57,40.14
4103,41,3,135,91,67.41,44,32.59
4104,41,4,150,108,72.0,42,28.0
4105,41,5,150,93,62.0,57,38.0
4106,41,6,224,131,58.48,93,41.52
4107,41,7,130,80,61.54,50,38.46
4108,41,8,130,84,64.62,46,35.38
4109,41,9,132,83,62.88,49,37.12
4110,41,10,186,122,65.59,64,34.41
4111,41,11,156,87,55.77,69,44.23
4112,41,12,120,68,56.67,52,43.33
4113,41,13,134,82,61.19,52,38.81
4114,41,14,224,157,70.09,67,29.91
4115,41,15,205,109,53.17,96,46.83
4116,41,16,122,83,68.03,39,31.97
4117,41,17,122,78,63.93,44,36.07
4118,41,18,113,64,56.64,49,43.36
4119,41,19,187,124,66.31,63,33.69
4120,41,20,81,56,69.14,25,30.86
4121,41,21,159,94,59.12,65,40.88
4122,41,22,179,98,54.75,81,45.25
4123,41,23,119,64,53.78,55,46.22
4124,41,24,115,66,57.39,49,42.61
4125,41,25,57,29,50.88,28,49.12
4126,41,26,137,89,64.96,48,35.04
4127,41,27,67,42,62.69,25,37.31
4128,41,28,84,41,48.81,43,51.19
4129,41,29,45,23,51.11,22,48.89
4130,41,30,145,86,59.31,59,40.69
4131,41,31,134,92,68.66,42,31.34
4132,41,32,133,79,59.4,54,40.6
4133,41,33,125,80,64.0,45,36.0
4134,41,34,116,71,61.21,45,38.79
4135,41,35,186,95,51.08,91,48.92
4136,41,36,142,84,59.15,58,40.85
4137,41,37,163,92,56.44,71,43.56
4138,41,38,118,69,58.47,49,41.53
4139,41,39,184,112,60.87,72,39.13
4140,41,40,165,105,63.64,60,36.36
4141,41,41,115,70,60.87,45,39.13
4142,41,42,126,68,53.97,58,46.03
4143,41,43,133,84,63.16,49,36.84
4144,41,44,134,82,61.19,52,38.81
4145,41,45,138,86,62.32,52,37.68
4146,41,46,165,87,52.73,78,47.27
4147,41,47,195,123,63.08,72,36.92
4201,42,1,211,149,70.62,62,29.38
4202,42,2,110,59,53.64,51,46.36
4203,42,3,166,105,63.25,61,36.75
4204,42,4,280,156,55.71,124,44.29
4205,42,5,141,97,68.79,44,31.21
4206,42,6,236,138,58.47,98,41.53
4207,42,7,203,147,72.41,56,27.59
4208,42,8,194,115,59.28,79,40.72
4209,42,9,148,69,46.62,79,53.38
4210,42,10,219,153,69.86,66,30.14
4211,42,11,138,83,60.14,55,39.86
4212,42,12,167,109,65.27,58,34.73
4213,42,13,215,139,64.65,76,35.35
4214,42,14,159,93,58.49,66,41.51
4215,42,15,167,103,61.68,64,38.32
4216,42,16,157,90,57.32,67,42.68
4217,42,17,162,94,58.02,68,41.98
4218,42,18,116,67,57.76,49,42.24
4219,42,19,248,154,62.1,94,37.9
4220,42,20,127,69,54.33,58,45.67
4221,42,21,147,76,51.7,71,48.3
4222,42,22,76,53,69.74,23,30.26
4223,42,23,179,113,63.13,66,36.87
4224,42,24,157,97,61.78,60,38.22
4225,42,25,148,79,53.38,69,46.62
4226,42,26,199,107,53.77,92,46.23
4227,42,27,138,88,63.77,50,36.23
4228,42,28,233,122,52.36,111,47.64
4229,42,29,236,126,53.39,110,46.61
4230,42,30,195,130,66.67,65,33.33
4231,42,31,186,109,58.6,77,41.4
4232,42,32,110,56,50.91,54,49.09
4233,42,33,216,129,59.72,87,40.28
4234,42,34,161,105,65.22,56,34.78
4235,42,35,205,134,65.37,71,34.63
4236,42,36,183,100,54.64,83,45.36
4237,42,37,97,62,63.92,35,36.08
4238,42,38,116,68,58.62,48,41.38
4239,42,39,141,86,60.99,55,39.01
4240,42,40,166,83,50.0,83,50.0
4241,42,41,167,103,61.68,64,38.32
4242,42,42,255,167,65.49,88,34.51
4301,43,1,91,52,57.14,39,42.86
4302,43,2,186,128,68.82,58,31.18
4303,43,3,167,106,63.47,61,36.53
4304,43,4,157,103,65.61,54,34.39
4305,43,5,165,123,74.55,42,25.45
4306,43,6,128,85,66.41,43,33.59
4307,43,7,142,94,66.2,48,33.8
4308,43,8,131,83,63.36,48,36.64
4309,43,9,175,97,55.43,78,44.57
4310,43,10,205,146,71.22,59,28.78
4311,43,11,115,80,69.57,35,30.43
4312,43,12,101,57,56.44,44,43.56
4313,43,13,177,100,56.5,77,43.5
4314,43,14,183,125,68.31,58,31.69
4315,43,15,160,102,63.75,58,36.25
4316,43,16,188,125,66.49,63,33.51
4317,43,17,131,82,62.6,49,37.4
4318,43,18,192,115,59.9,77,40.1
4319,43,19,181,137,75.69,44,24.31
4320,43,20,221,151,68.33,70,31.67
4321,43,21,149,97,65.1,52,34.9
4322,43,22,128,73,57.03,55,42.97
4323,43,23,113,77,68.14,36,31.86
4324,43,24,143,80,55.94,63,44.06
4325,43,25,200,145,72.5,55,27.5
4326,43,26,166,129,77.71,37,22.29
4327,43,27,171,119,69.59,52,30.41
4328,43,28,157,99,63.06,58,36.94
4329,43,29,210,142,67.62,68,32.38
4330,43,30,167,115,68.86,52,31.14
4331,43,31,169,85,50.3,84,49.7
4332,43,32,153,114,74.51,39,25.49
4333,43,33,213,151,70.89,62,29.11
4334,43,34,119,95,79.83,24,20.17
4335,43,35,205,154,75.12,51,24.88
4336,43,36,75,46,61.33,29,38.67
4337,43,37,144,95,65.97,49,34.03
4338,43,38,149,113,75.84,36,24.16
4339,43,39,98,56,57.14,42,42.86
4340,43,40,105,58,55.24,47,44.76
4341,43,41,178,125,70.22,53,29.78
4342,43,42,152,103,67.76,49,32.24
4343,43,43,193,137,70.98,56,29.02
4344,43,44,166,122,73.49,44,26.51
4345,43,45,123,100,81.3,23,18.7
4346,43,46,94,57,60.64,37,39.36
4401,44,1,307,197,64.17,110,35.83
4402,44,2,181,114,62.98,67,37.02
4403,44,3,178,134,75.28,44,24.72
4404,44,4,182,114,62.64,68,37.36
4405,44,5,184,93,50.54,91,49.46
4406,44,6,215,150,69.77,65,30.23
4407,44,7,173,126,72.83,47,27.17
4408,44,8,226,138,61.06,88,38.94
4409,44,9,141,91,64.54,50,35.46
4410,44,10,155,105,67.74,50,32.26
4411,44,11,175,123,70.29,52,29.71
4412,44,12,255,184,72.16,71,27.84
4413,44,13,137,79,57.66,58,42.34
4414,44,14,171,112,65.5,59,34.5
4415,44,15,192,121,63.02,71,36.98
4416,44,16,203,127,62.56,76,37.44
4417,44,17,272,187,68.75,85,31.25
4418,44,18,195,129,66.15,66,33.85
4419,44,19,270,193,71.48,77,28.52
4420,44,20,198,119,60.1,79,39.9
4421,44,21,199,124,62.31,75,37.69
4422,44,22,200,141,70.5,59,29.5
4423,44,23,156,108,69.23,48,30.77
4424,44,24,184,132,71.74,52,28.26
4425,44,25,229,145,63.32,84,36.68
4426,44,26,218,126,57.8,92,42.2
4427,44,27,201,126,62.69,75,37.31
4428,44,28,188,126,67.02,62,32.98
4429,44,29,197,125,63.45,72,36.55
4430,44,30,223,145,65.02,78,34.98
4431,44,31,128,88,68.75,40,31.25
4432,44,32,174,112,64.37,62,35.63
4433,44,33,210,141,67.14,69,32.86
4434,44,34,216,128,59.26,88,40.74
4435,44,35,246,164,66.67,82,33.33
4436,44,36,180,110,61.11,70,38.89
4437,44,37,274,181,66.06,93,33.94
4438,44,38,168,90,53.57,78,46.43
4439,44,39,193,120,62.18,73,37.82
4440,44,40,179,132,73.74,47,26.26
4441,44,41,234,130,55.56,104,44.44
4501,45,1,170,127,74.71,43,25.29
4502,45,2,199,134,67.34,65,32.66
4503,45,3,186,113,60.75,73,39.25
4504,45,4,235,165,70.21,70,29.79
4505,45,5,195,136,69.74,59,30.26
4506,45,6,292,202,69.18,90,30.82
4507,45,7,287,194,67.6,93,32.4
4508,45,8,153,104,67.97,49,32.03
4509,45,9,143,87,60.84,56,39.16
4510,45,10,168,108,64.29,60,35.71
4511,45,11,90,56,62.22,34,37.78
4512,45,12,137,79,57.66,58,42.34
4513,45,13,149,107,71.81,42,28.19
4514,45,14,220,129,58.64,91,41.36
4515,45,15,241,163,67.63,78,32.37
4516,45,16,164,123,75.0,41,25.0
4517,45,17,173,116,67.05,57,32.95
4518,45,18,162,87,53.7,75,46.3
4519,45,19,69,35,50.72,34,49.28
4520,45,20,96,69,71.88,27,28.13
4521,45,21,142,89,62.68,53,37.32
4522,45,22,109,67,61.47,42,38.53
4523,45,23,125,79,63.2,46,36.8
4524,45,24,96,66,68.75,30,31.25
4525,45,25,105,67,63.81,38,36.19
4526,45,26,78,50,64.1,28,35.9
4527,45,27,135,93,68.89,42,31.11
4528,45,28,121,74,61.16,47,38.84
4529,45,29,107,76,71.03,31,28.97
4530,45,30,127,76,59.84,51,40.16
4531,45,31,125,76,60.8,49,39.2
4532,45,32,127,82,64.57,45,35.43
4533,45,33,120,81,67.5,39,32.5
4534,45,34,152,96,63.16,56,36.84
4535,45,35,177,135,76.27,42,23.73
4536,45,36,185,124,67.03,61,32.97
4537,45,37,155,94,60.65,61,39.35
4538,45,38,127,82,64.57,45,35.43
4539,45,39,140,74,52.86,66,47.14
4540,45,40,133,73,54.89,60,45.11
4541,45,41,119,83,69.75,36,30.25
4542,45,42,162,98,60.49,64,39.51
4543,45,43,131,77,58.78,54,41.22
4544,45,44,174,108,62.07,66,37.93
4545,45,45,77,45,58.44,32,41.56
4546,45,46,92,62,67.39,30,32.61
4547,45,47,100,62,62.0,38,38.0
4548,45,48,101,60,59.41,41,40.59
4601,46,1,155,86,55.48,69,44.52
4602,46,2,225,143,63.56,82,36.44
4603,46,3,278,185,66.55,93,33.45
4604,46,4,234,157,67.09,77,32.91
4605,46,5,226,155,68.58,71,31.42
4606,46,6,187,114,60.96,73,39.04
4607,46,7,273,184,67.4,89,32.6
4608,46,8,146,71,48.63,75,51.37
4609,46,9,232,142,61.21,90,38.79
4610,46,10,273,174,63.74,99,36.26
4611,46,11,184,118,64.13,66,35.87
4612,46,12,260,196,75.38,64,24.62
4613,46,13,232,143,61.64,89,38.36
4614,46,14,148,81,54.73,67,45.27
4615,46,15,213,134,62.91,79,37.09
4616,46,16,290,193,66.55,97,33.45
4617,46,17,245,174,71.02,71,28.98
4618,46,18,215,126,58.6,89,41.4
4619,46,19,178,120,67.42,58,32.58
4620,46,20,193,121,62.69,72,37.31
4621,46,21,93,58,62.37,35,37.63
4622,46,22,137,81,59.12,56,40.88
4623,46,23,188,109,57.98,79,42.02
4624,46,24,308,193,62.66,115,37.34
4625,46,25,223,137,61.43,86,38.57
4626,46,26,248,153,61.69,95,38.31
4627,46,27,223,142,63.68,81,36.32
4628,46,28,202,146,72.28,56,27.72
4629,46,29,165,121,73.33,44,26.67
4630,46,30,196,124,63.27,72,36.73
4631,46,31,206,129,62.62,77,37.38
4632,46,32,85,41,48.24,44,51.76
4633,46,33,234,162,69.23,72,30.77
4634,46,34,254,158,62.2,96,37.8
4635,46,35,164,100,60.98,64,39.02
4636,46,36,235,148,62.98,87,37.02
4637,46,37,136,83,61.03,53,38.97
4638,46,38,188,101,53.72,87,46.28
4639,46,39,186,119,63.98,67,36.02
4640,46,40,231,151,65.37,80,34.63
4701,47,1,156,107,68.59,49,31.41
4702,47,2,202,147,72.77,55,27.23
4703,47,3,215,131,60.93,84,39.07
4704,47,4,240,151,62.92,89,37.08
4705,47,5,276,182,65.94,94,34.06
4706,47,6,238,144,60.5,94,39.5
4707,47,7,194,118,60.82,76,39.18
4708,47,8,234,146,62.39,88,37.61
4709,47,9,164,101,61.59,63,38.41
4710,47,10,320,217,67.81,103,32.19
4711,47,11,204,137,67.16,67,32.84
4712,47,12,233,128,54.94,105,45.06
4713,47,13,268,178,66.42,90,33.58
4714,47,14,219,128,58.45,91,41.55
4715,47,15,308,215,69.81,93,30.19
4716,47,16,212,130,61.32,82,38.68
4717,47,17,238,143,60.08,95,39.92
4718,47,18,219,139,63.47,80,36.53
4719,47,19,380,235,61.84,145,38.16
4720,47,20,249,167,67.07,82,32.93
4721,47,21,278,177,63.67,101,36.33
4722,47,22,293,184,62.8,109,37.2
4723,47,23,272,176,64.71,96,35.29
4724,47,24,263,161,61.22,102,38.78
4725,47,25,265,141,53.21,124,46.79
4726,47,26,307,185,60.26,122,39.74
4727,47,27,229,151,65.94,78,34.06
4728,47,28,228,154,67.54,74,32.46
4729,47,29,252,158,62.7,94,37.3
4730,47,30,297,196,65.99,101,34.01
4731,47,31,275,176,64.0,99,36.0
4732,47,32,338,209,61.83,129,38.17
4733,47,33,199,125,62.81,74,37.19
4734,47,34,253,157,62.06,96,37.94
4735,47,35,166,103,62.05,63,37.95
4736,47,36,288,172,59.72,116,40.28
4737,47,37,234,145,61.97,89,38.03
4738,47,38,265,168,63.4,97,36.6
4739,47,39,289,158,54.67,131,45.33
4740,47,40,203,129,63.55,74,36.45
4741,47,41,273,168,61.54,105,38.46
4742,47,42,230,145,63.04,85,36.96
4743,47,43,194,108,55.67,86,44.33
4744,47,44,194,108,55.67,86,44.33
4745,47,45,273,170,62.27,103,37.73
4746,47,46,115,62,53.91,53,46.09
4747,47,47,245,183,74.69,62,25.31
4748,47,48,23,8,34.78,15,65.22
4801,48,1,251,188,74.9,63,25.1
4802,48,2,110,86,78.18,24,21.82
4803,48,3,213,115,53.99,98,46.01
4804,48,4,256,169,66.02,87,33.98
4805,48,5,207,157,75.85,50,24.15
4806,48,6,218,126,57.8,92,42.2
4807,48,7,283,203,71.73,80,28.27
4808,48,8,131,95,72.52,36,27.48
4809,48,9,155,96,61.94,59,38.06
4810,48,10,363,261,71.9,102,28.1
4811,48,11,221,157,71.04,64,28.96
4812,48,12,282,198,70.21,84,29.79
4813,48,13,292,186,63.7,106,36.3
4814,48,14,119,70,58.82,49,41.18
4815,48,15,101,66,65.35,35,34.65
4816,48,16,219,135,61.64,84,38.36
4817,48,17,235,130,55.32,105,44.68
4818,48,18,151,79,52.32,72,47.68
4819,48,19,201,130,64.68,71,35.32
4820,48,20,271,180,66.42,91,33.58
4821,48,21,250,149,59.6,101,40.4
4822,48,22,230,137,59.57,93,40.43
4823,48,23,296,201,67.91,95,32.09
4824,48,24,193,102,52.85,91,47.15
4825,48,25,218,155,71.1,63,28.9
4826,48,26,96,62,64.58,34,35.42
4827,48,27,128,76,59.38,52,40.63
4828,48,28,234,109,46.58,125,53.42
4829,48,29,157,97,61.78,60,38.22
4830,48,30,228,151,66.23,77,33.77
4831,48,31,218,110,50.46,108,49.54
4832,48,32,188,115,61.17,73,38.83
4833,48,33,138,98,71.01,40,28.99
4834,48,34,204,143,70.1,61,29.9
4835,48,35,126,70,55.56,56,44.44
4836,48,36,156,104,66.67,52,33.33
4837,48,37,243,170,69.96,73,30.04
4838,48,38,274,188,68.61,86,31.39
4839,48,39,200,127,63.5,73,36.5
4840,48,40,200,140,70.0,60,30.0
4841,48,41,214,122,57.01,92,42.99
4842,48,42,291,200,68.73,91,31.27
4843,48,43,247,149,60.32,98,39.68
4844,48,44,282,204,72.34,78,27.66
4845,48,45,152,105,69.08,47,30.92
4846,48,46,160,89,55.63,71,44.38
4901,49,1,111,50,45.05,61,54.95
4902,49,2,142,102,71.83,40,28.17
4903,49,3,243,158,65.02,85,34.98
4904,49,4,241,164,68.05,77,31.95
4905,49,5,216,123,56.94,93,43.06
4906,49,6,169,110,65.09,59,34.91
4907,49,7,167,121,72.46,46,27.54
4908,49,8,158,103,65.19,55,34.81
4909,49,9,205,138,67.32,67,32.68
4910,49,10,219,159,72.6,60,27.4
4911,49,11,229,165,72.05,64,27.95
4912,49,12,220,148,67.27,72,32.73
4913,49,13,244,156,63.93,88,36.07
4914,49,14,141,87,61.7,54,38.3
4915,49,15,139,85,61.15,54,38.85
4916,49,16,192,127,66.15,65,33.85
4917,49,17,159,90,56.6,69,43.4
4918,49,18,248,167,67.34,81,32.66
4919,49,19,140,89,63.57,51,36.43
4920,49,20,308,218,70.78,90,29.22
4921,49,21,92,59,64.13,33,35.87
4922,49,22,207,131,63.29,76,36.71
4923,49,23,228,145,63.6,83,36.4
4924,49,24,128,76,59.38,52,40.63
4925,49,25,238,174,73.11,64,26.89
4926,49,26,212,128,60.38,84,39.62
4927,49,27,166,112,67.47,54,32.53
4928,49,28,285,201,70.53,84,29.47
4929,49,29,240,164,68.33,76,31.67
4930,49,30,191,131,68.59,60,31.41
4931,49,31,131,77,58.78,54,41.22
4932,49,32,193,117,60.62,76,39.38
4933,49,33,168,104,61.9,64,38.1
5001,50,1,143,92,64.34,51,35.66
5002,50,2,86,52,60.47,34,39.53
5003,50,3,147,102,69.39,45,30.61
5004,50,4,176,117,66.48,59,33.52
5005,50,5,106,73,68.87,33,31.13
5006,50,6,172,101,58.72,71,41.28
5007,50,7,220,159,72.27,61,27.73
5008,50,8,131,80,61.07,51,38.93
5009,50,9,122,77,63.11,45,36.89
5010,50,10,96,54,56.25,42,43.75
5011,50,11,81,47,58.02,34,41.98
5012,50,12,60,47,78.33,13,21.67
5013,50,13,129,76,58.91,53,41.09
5014,50,14,46,36,78.26,10,21.74
5015,50,15,230,171,74.35,59,25.65
5016,50,16,57,41,71.93,16,28.07
5017,50,17,96,45,46.88,51,53.13
5018,50,18,23,16,69.57,7,30.43
5019,50,19,76,44,57.89,32,42.11
5020,50,20,160,111,69.38,49,30.63
5021,50,21,136,82,60.29,54,39.71
5022,50,22,102,56,54.9,46,45.1
5023,50,23,63,34,53.97,29,46.03
5024,50,24,81,48,59.26,33,40.74
5025,50,25,111,68,61.26,43,38.74
5026,50,26,101,60,59.41,41,40.59
5027,50,27,44,26,59.09,18,40.91
5028,50,28,127,73,57.48,54,42.52
5029,50,29,73,44,60.27,29,39.73
5030,50,30,111,73,65.77,38,34.23
5031,50,31,128,67,52.34,61,47.66
5032,50,32,111,62,55.86,49,44.14
5033,50,33,120,79,65.83,41,34.17
5034,50,34,211,150,71.09,61,28.91
5035,50,35,199,139,69.85,60,30.15
5036,50,36,173,120,69.36,53,30.64
5037,50,37,130,77,59.23,53,40.77
5038,50,38,72,50,69.44,22,30.56
5039,50,39,63,27,42.86,36,57.14
5040,50,40,123,69,56.1,54,43.9
