id,ward,precinct,total,Yes,Yes Percent,No,No Percent
0101,1,1,729,430,58.98,299,41.02
0102,1,2,689,426,61.83,263,38.17
0103,1,3,778,491,63.11,287,36.89
0104,1,4,697,449,64.42,248,35.58
0105,1,5,706,425,60.2,281,39.8
0106,1,6,620,391,63.06,229,36.94
0107,1,7,740,421,56.89,319,43.11
0108,1,8,667,422,63.27,245,36.73
0109,1,9,342,222,64.91,120,35.09
0110,1,10,875,610,69.71,265,30.29
0111,1,11,663,421,63.5,242,36.5
0112,1,12,286,199,69.58,87,30.42
0113,1,13,473,299,63.21,174,36.79
0114,1,14,395,287,72.66,108,27.34
0115,1,15,693,465,67.1,228,32.9
0116,1,16,655,424,64.73,231,35.27
0117,1,17,435,277,63.68,158,36.32
0118,1,18,623,404,64.85,219,35.15
0119,1,19,590,408,69.15,182,30.85
0120,1,20,537,406,75.61,131,24.39
0121,1,21,565,362,64.07,203,35.93
0122,1,22,751,506,67.38,245,32.62
0123,1,23,386,263,68.13,123,31.87
0124,1,24,842,578,68.65,264,31.35
0125,1,25,702,475,67.66,227,32.34
0126,1,26,627,432,68.9,195,31.1
0201,2,1,640,507,79.22,133,20.78
0202,2,2,753,591,78.49,162,21.51
0203,2,3,473,368,77.8,105,22.2
0204,2,4,512,403,78.71,109,21.29
0205,2,5,497,387,77.87,110,22.13
0206,2,6,719,563,78.3,156,21.7
0207,2,7,623,480,77.05,143,22.95
0208,2,8,493,394,79.92,99,20.08
0209,2,9,723,560,77.46,163,22.54
0210,2,10,321,240,74.77,81,25.23
0211,2,11,548,419,76.46,129,23.54
0212,2,12,507,385,75.94,122,24.06
0213,2,13,671,514,76.6,157,23.4
0214,2,14,382,281,73.56,101,26.44
0215,2,15,548,426,77.74,122,22.26
0216,2,16,629,494,78.54,135,21.46
0217,2,17,901,707,78.47,194,21.53
0218,2,18,527,397,75.33,130,24.67
0219,2,19,297,246,82.83,51,17.17
0220,2,20,378,283,74.87,95,25.13
0221,2,21,118,75,63.56,43,36.44
0222,2,22,443,342,77.2,101,22.8
0223,2,23,487,386,79.26,101,20.74
0224,2,24,391,298,76.21,93,23.79
0225,2,25,587,437,74.45,150,25.55
0301,3,1,581,413,71.08,168,28.92
0302,3,2,553,480,86.8,73,13.2
0303,3,3,399,297,74.44,102,25.56
0304,3,4,435,352,80.92,83,19.08
0305,3,5,113,91,80.53,22,19.47
0306,3,6,579,421,72.71,158,27.29
0307,3,7,275,210,76.36,65,23.64
0308,3,8,455,339,74.51,116,25.49
0309,3,9,358,263,73.46,95,26.54
0310,3,10,384,295,76.82,89,23.18
0311,3,11,618,492,79.61,126,20.39
0312,3,12,454,337,74.23,117,25.77
0313,3,13,656,507,77.29,149,22.71
0314,3,14,755,550,72.85,205,27.15
0315,3,15,454,379,83.48,75,16.52
0316,3,16,270,221,81.85,49,18.15
0317,3,17,157,119,75.8,38,24.2
0318,3,18,182,123,67.58,59,32.42
0319,3,19,771,600,77.82,171,22.18
0320,3,20,511,401,78.47,110,21.53
0321,3,21,496,372,75.0,124,25.0
0322,3,22,381,277,72.7,104,27.3
0323,3,23,286,216,75.52,70,24.48
0324,3,24,109,87,79.82,22,20.18
0325,3,25,751,597,79.49,154,20.51
0326,3,26,265,189,71.32,76,28.68
0327,3,27,648,490,75.62,158,24.38
0401,4,1,702,511,72.79,191,27.21
0402,4,2,249,186,74.7,63,25.3
0403,4,3,470,370,78.72,100,21.28
0404,4,4,570,450,78.95,120,21.05
0405,4,5,285,226,79.3,59,20.7
0406,4,6,407,314,77.15,93,22.85
0407,4,7,295,223,75.59,72,24.41
0408,4,8,417,351,84.17,66,15.83
0409,4,9,448,345,77.01,103,22.99
0410,4,10,406,330,81.28,76,18.72
0411,4,11,550,425,77.27,125,22.73
0412,4,12,342,272,79.53,70,20.47
0413,4,13,370,296,80.0,74,20.0
0414,4,14,307,248,80.78,59,19.22
0415,4,15,335,256,76.42,79,23.58
0416,4,16,464,369,79.53,95,20.47
0417,4,17,592,473,79.9,119,20.1
0418,4,18,185,137,74.05,48,25.95
0419,4,19,385,290,75.32,95,24.68
0420,4,20,566,451,79.68,115,20.32
0421,4,21,363,294,80.99,69,19.01
0422,4,22,186,150,80.65,36,19.35
0423,4,23,334,260,77.84,74,22.16
0424,4,24,622,496,79.74,126,20.26
0425,4,25,762,606,79.53,156,20.47
0426,4,26,666,533,80.03,133,19.97
0427,4,27,728,519,71.29,209,28.71
0428,4,28,755,551,72.98,204,27.02
0501,5,1,522,408,78.16,114,21.84
0502,5,2,625,496,79.36,129,20.64
0503,5,3,579,466,80.48,113,19.52
0504,5,4,470,367,78.09,103,21.91
0505,5,5,253,204,80.63,49,19.37
0506,5,6,227,184,81.06,43,18.94
0507,5,7,132,109,82.58,23,17.42
0508,5,8,174,133,76.44,41,23.56
0509,5,9,162,126,77.78,36,22.22
0510,5,10,267,203,76.03,64,23.97
0511,5,11,344,255,74.13,89,25.87
0512,5,12,591,478,80.88,113,19.12
0513,5,13,265,203,76.6,62,23.4
0514,5,14,288,239,82.99,49,17.01
0515,5,15,889,700,78.74,189,21.26
0516,5,16,548,419,76.46,129,23.54
0517,5,17,380,324,85.26,56,14.74
0518,5,18,809,645,79.73,164,20.27
0519,5,19,350,306,87.43,44,12.57
0520,5,20,610,472,77.38,138,22.62
0521,5,21,514,394,76.65,120,23.35
0522,5,22,607,418,68.86,189,31.14
0523,5,23,322,263,81.68,59,18.32
0524,5,24,315,253,80.32,62,19.68
0525,5,25,788,622,78.93,166,21.07
0601,6,1,167,131,78.44,36,21.56
0602,6,2,209,174,83.25,35,16.75
0603,6,3,71,50,70.42,21,29.58
0604,6,4,162,126,77.78,36,22.22
0605,6,5,293,228,77.82,65,22.18
0606,6,6,268,202,75.37,66,24.63
0607,6,7,344,270,78.49,74,21.51
0608,6,8,261,213,81.61,48,18.39
0609,6,9,544,432,79.41,112,20.59
0610,6,10,127,98,77.17,29,22.83
0611,6,11,148,116,78.38,32,21.62
0612,6,12,357,274,76.75,83,23.25
0613,6,13,460,355,77.17,105,22.83
0614,6,14,432,345,79.86,87,20.14
0615,6,15,462,355,76.84,107,23.16
0616,6,16,297,234,78.79,63,21.21
0617,6,17,518,401,77.41,117,22.59
0618,6,18,603,491,81.43,112,18.57
0619,6,19,378,295,78.04,83,21.96
0620,6,20,645,540,83.72,105,16.28
0621,6,21,467,363,77.73,104,22.27
0622,6,22,644,518,80.43,126,19.57
0623,6,23,608,496,81.58,112,18.42
0624,6,24,553,451,81.56,102,18.44
0625,6,25,401,329,82.04,72,17.96
0626,6,26,704,589,83.66,115,16.34
0627,6,27,635,514,80.94,121,19.06
0701,7,1,480,367,76.46,113,23.54
0702,7,2,618,503,81.39,115,18.61
0703,7,3,328,248,75.61,80,24.39
0704,7,4,396,297,75.0,99,25.0
0705,7,5,539,430,79.78,109,20.22
0706,7,6,139,114,82.01,25,17.99
0707,7,7,326,258,79.14,68,20.86
0708,7,8,217,165,76.04,52,23.96
0709,7,9,354,271,76.55,83,23.45
0710,7,10,519,418,80.54,101,19.46
0711,7,11,431,349,80.97,82,19.03
0712,7,12,522,417,79.89,105,20.11
0713,7,13,371,290,78.17,81,21.83
0714,7,14,320,253,79.06,67,20.94
0715,7,15,474,393,82.91,81,17.09
0716,7,16,158,127,80.38,31,19.62
0717,7,17,128,101,78.91,27,21.09
0718,7,18,59,53,89.83,6,10.17
0719,7,19,615,503,81.79,112,18.21
0720,7,20,341,272,79.77,69,20.23
0721,7,21,260,217,83.46,43,16.54
0722,7,22,298,253,84.9,45,15.1
0723,7,23,219,167,76.26,52,23.74
0724,7,24,63,44,69.84,19,30.16
0725,7,25,329,269,81.76,60,18.24
0726,7,26,471,384,81.53,87,18.47
0727,7,27,276,221,80.07,55,19.93
0728,7,28,180,146,81.11,34,18.89
0729,7,29,272,205,75.37,67,24.63
0730,7,30,245,193,78.78,52,21.22
0731,7,31,113,96,84.96,17,15.04
0801,8,1,490,374,76.33,116,23.67
0802,8,2,251,189,75.3,62,24.7
0803,8,3,197,164,83.25,33,16.75
0804,8,4,458,366,79.91,92,20.09
0805,8,5,328,273,83.23,55,16.77
0806,8,6,558,450,80.65,108,19.35
0807,8,7,329,269,81.76,60,18.24
0808,8,8,698,586,83.95,112,16.05
0809,8,9,444,358,80.63,86,19.37
0810,8,10,519,397,76.49,122,23.51
0811,8,11,416,339,81.49,77,18.51
0812,8,12,475,398,83.79,77,16.21
0813,8,13,447,380,85.01,67,14.99
0814,8,14,509,431,84.68,78,15.32
0815,8,15,386,319,82.64,67,17.36
0816,8,16,356,294,82.58,62,17.42
0817,8,17,597,507,84.92,90,15.08
0818,8,18,772,639,82.77,133,17.23
0819,8,19,617,503,81.52,114,18.48
0820,8,20,267,209,78.28,58,21.72
0821,8,21,232,177,76.29,55,23.71
0822,8,22,227,195,85.9,32,14.1
0823,8,23,593,480,80.94,113,19.06
0824,8,24,429,344,80.19,85,19.81
0825,8,25,167,134,80.24,33,19.76
0826,8,26,350,278,79.43,72,20.57
0827,8,27,460,372,80.87,88,19.13
0828,8,28,312,234,75.0,78,25.0
0829,8,29,309,256,82.85,53,17.15
0830,8,30,396,319,80.56,77,19.44
0901,9,1,489,373,76.28,116,23.72
0902,9,2,327,253,77.37,74,22.63
0903,9,3,167,134,80.24,33,19.76
0904,9,4,364,283,77.75,81,22.25
0905,9,5,355,280,78.87,75,21.13
0906,9,6,606,487,80.36,119,19.64
0907,9,7,461,358,77.66,103,22.34
0908,9,8,471,367,77.92,104,22.08
0909,9,9,285,225,78.95,60,21.05
0910,9,10,578,467,80.8,111,19.2
0911,9,11,193,147,76.17,46,23.83
0912,9,12,533,443,83.11,90,16.89
0913,9,13,507,408,80.47,99,19.53
0914,9,14,287,247,86.06,40,13.94
0915,9,15,383,320,83.55,63,16.45
0916,9,16,535,428,80.0,107,20.0
0917,9,17,168,134,79.76,34,20.24
0918,9,18,274,233,85.04,41,14.96
0919,9,19,233,190,81.55,43,18.45
0920,9,20,411,305,74.21,106,25.79
0921,9,21,485,395,81.44,90,18.56
0922,9,22,335,264,78.81,71,21.19
0923,9,23,274,224,81.75,50,18.25
0924,9,24,414,340,82.13,74,17.87
0925,9,25,315,254,80.63,61,19.37
0926,9,26,447,363,81.21,84,18.79
0927,9,27,258,202,78.29,56,21.71
0928,9,28,212,168,79.25,44,20.75
0929,9,29,607,493,81.22,114,18.78
0930,9,30,491,398,81.06,93,18.94
1001,10,1,125,102,81.6,23,18.4
1002,10,2,152,110,72.37,42,27.63
1003,10,3,254,188,74.02,66,25.98
1004,10,4,290,226,77.93,64,22.07
1005,10,5,113,80,70.8,33,29.2
1006,10,6,136,104,76.47,32,23.53
1007,10,7,269,176,65.43,93,34.57
1008,10,8,256,192,75.0,64,25.0
1009,10,9,284,216,76.06,68,23.94
1010,10,10,305,210,68.85,95,31.15
1011,10,11,109,78,71.56,31,28.44
1012,10,12,279,202,72.4,77,27.6
1013,10,13,313,224,71.57,89,28.43
1014,10,14,402,276,68.66,126,31.34
1015,10,15,371,269,72.51,102,27.49
1016,10,16,432,283,65.51,149,34.49
1017,10,17,397,270,68.01,127,31.99
1018,10,18,482,308,63.9,174,36.1
1019,10,19,277,194,70.04,83,29.96
1020,10,20,190,135,71.05,55,28.95
1021,10,21,237,145,61.18,92,38.82
1022,10,22,413,266,64.41,147,35.59
1023,10,23,281,211,75.09,70,24.91
1024,10,24,126,100,79.37,26,20.63
1025,10,25,223,172,77.13,51,22.87
1101,11,1,143,98,68.53,45,31.47
1102,11,2,73,53,72.6,20,27.4
1103,11,3,416,268,64.42,148,35.58
1104,11,4,313,201,64.22,112,35.78
1105,11,5,333,218,65.47,115,34.53
1106,11,6,427,265,62.06,162,37.94
1107,11,7,215,150,69.77,65,30.23
1108,11,8,370,227,61.35,143,38.65
1109,11,9,408,277,67.89,131,32.11
1110,11,10,72,44,61.11,28,38.89
1111,11,11,61,41,67.21,20,32.79
1112,11,12,128,89,69.53,39,30.47
1113,11,13,369,251,68.02,118,31.98
1114,11,14,703,459,65.29,244,34.71
1115,11,15,508,311,61.22,197,38.78
1116,11,16,612,386,63.07,226,36.93
1117,11,17,279,179,64.16,100,35.84
1118,11,18,387,267,68.99,120,31.01
1119,11,19,129,86,66.67,43,33.33
1120,11,20,381,271,71.13,110,28.87
1121,11,21,657,473,71.99,184,28.01
1122,11,22,420,297,70.71,123,29.29
1123,11,23,461,300,65.08,161,34.92
1201,12,1,235,147,62.55,88,37.45
1202,12,2,173,132,76.3,41,23.7
1203,12,3,330,196,59.39,134,40.61
1204,12,4,276,168,60.87,108,39.13
1205,12,5,264,168,63.64,96,36.36
1206,12,6,229,156,68.12,73,31.88
1207,12,7,239,168,70.29,71,29.71
1208,12,8,228,175,76.75,53,23.25
1209,12,9,133,77,57.89,56,42.11
1210,12,10,275,184,66.91,91,33.09
1211,12,11,199,147,73.87,52,26.13
1212,12,12,173,124,71.68,49,28.32
1213,12,13,187,136,72.73,51,27.27
1214,12,14,111,88,79.28,23,20.72
1215,12,15,241,170,70.54,71,29.46
1216,12,16,273,193,70.7,80,29.3
1217,12,17,223,168,75.34,55,24.66
1218,12,18,246,184,74.8,62,25.2
1219,12,19,147,94,63.95,53,36.05
1220,12,20,197,143,72.59,54,27.41
1221,12,21,196,131,66.84,65,33.16
1222,12,22,197,141,71.57,56,28.43
1301,13,1,221,168,76.02,53,23.98
1302,13,2,271,195,71.96,76,28.04
1303,13,3,388,221,56.96,167,43.04
1304,13,4,295,217,73.56,78,26.44
1305,13,5,267,173,64.79,94,35.21
1306,13,6,281,162,57.65,119,42.35
1307,13,7,213,137,64.32,76,35.68
1308,13,8,339,239,70.5,100,29.5
1309,13,9,393,247,62.85,146,37.15
1310,13,10,385,235,61.04,150,38.96
1311,13,11,219,133,60.73,86,39.27
1312,13,12,207,141,68.12,66,31.88
1313,13,13,267,152,56.93,115,43.07
1314,13,14,240,144,60.0,96,40.0
1315,13,15,195,120,61.54,75,38.46
1316,13,16,311,213,68.49,98,31.51
1317,13,17,331,233,70.39,98,29.61
1318,13,18,234,169,72.22,65,27.78
1319,13,19,216,121,56.02,95,43.98
1320,13,20,316,192,60.76,124,39.24
1321,13,21,268,169,63.06,99,36.94
1322,13,22,339,248,73.16,91,26.84
1323,13,23,345,189,54.78,156,45.22
1324,13,24,269,187,69.52,82,30.48
1325,13,25,258,177,68.6,81,31.4
1326,13,26,203,138,67.98,65,32.02
1327,13,27,176,122,69.32,54,30.68
1328,13,28,222,155,69.82,67,30.18
1329,13,29,207,148,71.5,59,28.5
1330,13,30,323,179,55.42,144,44.58
1331,13,31,228,131,57.46,97,42.54
1332,13,32,229,140,61.14,89,38.86
1333,13,33,279,177,63.44,102,36.56
1334,13,34,337,203,60.24,134,39.76
1335,13,35,408,263,64.46,145,35.54
1336,13,36,168,132,78.57,36,21.43
1337,13,37,349,201,57.59,148,42.41
1338,13,38,188,122,64.89,66,35.11
1339,13,39,342,206,60.23,136,39.77
1340,13,40,280,175,62.5,105,37.5
1401,14,1,371,276,74.39,95,25.61
1402,14,2,260,182,70.0,78,30.0
1403,14,3,177,122,68.93,55,31.07
1404,14,4,84,63,75.0,21,25.0
1405,14,5,299,234,78.26,65,21.74
1406,14,6,382,266,69.63,116,30.37
1407,14,7,339,234,69.03,105,30.97
1408,14,8,346,242,69.94,104,30.06
1409,14,9,371,244,65.77,127,34.23
1410,14,10,323,224,69.35,99,30.65
1411,14,11,375,270,72.0,105,28.0
1412,14,12,247,163,65.99,84,34.01
1413,14,13,406,286,70.44,120,29.56
1414,14,14,205,147,71.71,58,28.29
1415,14,15,214,147,68.69,67,31.31
1501,15,1,247,178,72.06,69,27.94
1502,15,2,353,246,69.69,107,30.31
1503,15,3,128,90,70.31,38,29.69
1504,15,4,155,111,71.61,44,28.39
1505,15,5,100,73,73.0,27,27.0
1506,15,6,229,157,68.56,72,31.44
1507,15,7,180,114,63.33,66,36.67
1508,15,8,199,138,69.35,61,30.65
1509,15,9,226,145,64.16,81,35.84
1510,15,10,182,136,74.73,46,25.27
1511,15,11,178,136,76.4,42,23.6
1512,15,12,239,179,74.9,60,25.1
1513,15,13,185,135,72.97,50,27.03
1514,15,14,193,139,72.02,54,27.98
1515,15,15,191,138,72.25,53,27.75
1516,15,16,300,217,72.33,83,27.67
1517,15,17,335,255,76.12,80,23.88
1518,15,18,233,180,77.25,53,22.75
1519,15,19,139,103,74.1,36,25.9
1520,15,20,211,150,71.09,61,28.91
1601,16,1,294,227,77.21,67,22.79
1602,16,2,189,142,75.13,47,24.87
1603,16,3,243,188,77.37,55,22.63
1604,16,4,153,120,78.43,33,21.57
1605,16,5,333,261,78.38,72,21.62
1606,16,6,306,237,77.45,69,22.55
1607,16,7,188,150,79.79,38,20.21
1608,16,8,138,103,74.64,35,25.36
1609,16,9,309,239,77.35,70,22.65
1610,16,10,225,176,78.22,49,21.78
1611,16,11,206,148,71.84,58,28.16
1612,16,12,82,69,84.15,13,15.85
1613,16,13,125,97,77.6,28,22.4
1614,16,14,325,259,79.69,66,20.31
1615,16,15,257,193,75.1,64,24.9
1616,16,16,205,150,73.17,55,26.83
1617,16,17,371,284,76.55,87,23.45
1618,16,18,343,250,72.89,93,27.11
1619,16,19,273,193,70.7,80,29.3
1620,16,20,255,206,80.78,49,19.22
1621,16,21,173,136,78.61,37,21.39
1622,16,22,270,210,77.78,60,22.22
1623,16,23,194,136,70.1,58,29.9
1624,16,24,221,169,76.47,52,23.53
1625,16,25,105,87,82.86,18,17.14
1701,17,1,363,269,74.1,94,25.9
1702,17,2,221,166,75.11,55,24.89
1703,17,3,266,216,81.2,50,18.8
1704,17,4,269,214,79.55,55,20.45
1705,17,5,169,128,75.74,41,24.26
1706,17,6,250,197,78.8,53,21.2
1707,17,7,150,118,78.67,32,21.33
1708,17,8,202,163,80.69,39,19.31
1709,17,9,192,148,77.08,44,22.92
1710,17,10,387,309,79.84,78,20.16
1711,17,11,240,186,77.5,54,22.5
1712,17,12,152,119,78.29,33,21.71
1713,17,13,166,133,80.12,33,19.88
1714,17,14,180,142,78.89,38,21.11
1715,17,15,497,411,82.7,86,17.3
1716,17,16,220,173,78.64,47,21.36
1717,17,17,192,156,81.25,36,18.75
1718,17,18,570,446,78.25,124,21.75
1719,17,19,375,298,79.47,77,20.53
1720,17,20,382,313,81.94,69,18.06
1721,17,21,423,331,78.25,92,21.75
1722,17,22,422,326,77.25,96,22.75
1723,17,23,270,217,80.37,53,19.63
1724,17,24,456,366,80.26,90,19.74
1725,17,25,197,153,77.66,44,22.34
1726,17,26,388,320,82.47,68,17.53
1727,17,27,464,380,81.9,84,18.1
1728,17,28,535,422,78.88,113,21.12
1729,17,29,474,383,80.8,91,19.2
1801,18,1,590,483,81.86,107,18.14
1802,18,2,632,506,80.06,126,19.94
1803,18,3,266,215,80.83,51,19.17
1804,18,4,449,388,86.41,61,13.59
1805,18,5,373,307,82.31,66,17.69
1806,18,6,569,477,83.83,92,16.17
1807,18,7,504,416,82.54,88,17.46
1808,18,8,762,601,78.87,161,21.13
1809,18,9,613,493,80.42,120,19.58
1810,18,10,693,543,78.35,150,21.65
1811,18,11,378,309,81.75,69,18.25
1812,18,12,607,496,81.71,111,18.29
1813,18,13,497,402,80.89,95,19.11
1814,18,14,382,300,78.53,82,21.47
1815,18,15,287,232,80.84,55,19.16
1816,18,16,446,350,78.48,96,21.52
1817,18,17,328,234,71.34,94,28.66
1818,18,18,404,277,68.56,127,31.44
1819,18,19,358,282,78.77,76,21.23
1820,18,20,336,255,75.89,81,24.11
1821,18,21,454,358,78.85,96,21.15
1822,18,22,436,305,69.95,131,30.05
1823,18,23,516,343,66.47,173,33.53
1824,18,24,567,387,68.25,180,31.75
1825,18,25,305,211,69.18,94,30.82
1826,18,26,529,381,72.02,148,27.98
1901,19,1,707,434,61.39,273,38.61
1902,19,2,667,517,77.51,150,22.49
1903,19,3,473,229,48.41,244,51.59
1904,19,4,472,251,53.18,221,46.82
1905,19,5,545,431,79.08,114,20.92
1906,19,6,519,277,53.37,242,46.63
1907,19,7,674,387,57.42,287,42.58
1908,19,8,500,409,81.8,91,18.2
1909,19,9,448,349,77.9,99,22.1
1910,19,10,499,393,78.76,106,21.24
1911,19,11,431,231,53.6,200,46.4
1912,19,12,668,356,53.29,312,46.71
1913,19,13,452,359,79.42,93,20.58
1914,19,14,607,465,76.61,142,23.39
1915,19,15,391,184,47.06,207,52.94
1916,19,16,490,252,51.43,238,48.57
1917,19,17,455,288,63.3,167,36.7
1918,19,18,446,213,47.76,233,52.24
1919,19,19,539,416,77.18,123,22.82
1920,19,20,428,336,78.5,92,21.5
1921,19,21,684,371,54.24,313,45.76
1922,19,22,460,316,68.7,144,31.3
1923,19,23,477,302,63.31,175,36.69
1924,19,24,482,236,48.96,246,51.04
1925,19,25,464,365,78.66,99,21.34
1926,19,26,422,313,74.17,109,25.83
1927,19,27,686,508,74.05,178,25.95
1928,19,28,851,639,75.09,212,24.91
1929,19,29,591,317,53.64,274,46.36
1930,19,30,484,221,45.66,263,54.34
1931,19,31,739,537,72.67,202,27.33
1932,19,32,454,354,77.97,100,22.03
1933,19,33,344,166,48.26,178,51.74
1934,19,34,779,519,66.62,260,33.38
1935,19,35,536,395,73.69,141,26.31
1936,19,36,426,324,76.06,102,23.94
2001,20,1,210,149,70.95,61,29.05
2002,20,2,125,96,76.8,29,23.2
2003,20,3,142,99,69.72,43,30.28
2004,20,4,110,85,77.27,25,22.73
2005,20,5,202,146,72.28,56,27.72
2006,20,6,134,112,83.58,22,16.42
2007,20,7,159,125,78.62,34,21.38
2008,20,8,211,168,79.62,43,20.38
2009,20,9,394,317,80.46,77,19.54
2010,20,10,426,337,79.11,89,20.89
2011,20,11,343,259,75.51,84,24.49
2012,20,12,73,54,73.97,19,26.03
2013,20,13,606,459,75.74,147,24.26
2014,20,14,389,319,82.01,70,17.99
2015,20,15,340,260,76.47,80,23.53
2016,20,16,379,307,81.0,72,19.0
2017,20,17,477,361,75.68,116,24.32
2018,20,18,558,422,75.63,136,24.37
2019,20,19,323,242,74.92,81,25.08
2020,20,20,368,296,80.43,72,19.57
2021,20,21,518,363,70.08,155,29.92
2022,20,22,471,366,77.71,105,22.29
2023,20,23,158,117,74.05,41,25.95
2101,21,1,562,455,80.96,107,19.04
2102,21,2,172,145,84.3,27,15.7
2103,21,3,596,484,81.21,112,18.79
2104,21,4,490,404,82.45,86,17.55
2105,21,5,509,405,79.57,104,20.43
2106,21,6,442,355,80.32,87,19.68
2107,21,7,641,490,76.44,151,23.56
2108,21,8,466,362,77.68,104,22.32
2109,21,9,166,128,77.11,38,22.89
2110,21,10,580,457,78.79,123,21.21
2111,21,11,577,467,80.94,110,19.06
2112,21,12,252,207,82.14,45,17.86
2113,21,13,423,337,79.67,86,20.33
2114,21,14,639,531,83.1,108,16.9
2115,21,15,626,509,81.31,117,18.69
2116,21,16,546,442,80.95,104,19.05
2117,21,17,398,320,80.4,78,19.6
2118,21,18,597,485,81.24,112,18.76
2119,21,19,475,377,79.37,98,20.63
2120,21,20,328,249,75.91,79,24.09
2121,21,21,597,451,75.54,146,24.46
2122,21,22,622,486,78.14,136,21.86
2123,21,23,444,341,76.8,103,23.2
2124,21,24,430,345,80.23,85,19.77
2125,21,25,368,290,78.8,78,21.2
2126,21,26,399,329,82.46,70,17.54
2127,21,27,573,462,80.63,111,19.37
2128,21,28,508,385,75.79,123,24.21
2129,21,29,530,416,78.49,114,21.51
2201,22,1,177,138,77.97,39,22.03
2202,22,2,110,80,72.73,30,27.27
2203,22,3,220,160,72.73,60,27.27
2204,22,4,127,94,74.02,33,25.98
2205,22,5,359,241,67.13,118,32.87
2206,22,6,189,126,66.67,63,33.33
2207,22,7,196,124,63.27,72,36.73
2208,22,8,222,151,68.02,71,31.98
2209,22,9,186,137,73.66,49,26.34
2210,22,10,252,188,74.6,64,25.4
2211,22,11,318,237,74.53,81,25.47
2212,22,12,192,143,74.48,49,25.52
2213,22,13,249,185,74.3,64,25.7
2214,22,14,194,145,74.74,49,25.26
2215,22,15,128,86,67.19,42,32.81
2216,22,16,293,209,71.33,84,28.67
2217,22,17,126,93,73.81,33,26.19
2218,22,18,249,205,82.33,44,17.67
2219,22,19,412,284,68.93,128,31.07
2301,23,1,233,133,57.08,100,42.92
2302,23,2,402,229,56.97,173,43.03
2303,23,3,258,137,53.1,121,46.9
2304,23,4,212,99,46.7,113,53.3
2305,23,5,351,196,55.84,155,44.16
2306,23,6,201,106,52.74,95,47.26
2307,23,7,259,163,62.93,96,37.07
2308,23,8,240,148,61.67,92,38.33
2309,23,9,409,261,63.81,148,36.19
2310,23,10,450,287,63.78,163,36.22
2311,23,11,181,125,69.06,56,30.94
2312,23,12,256,165,64.45,91,35.55
2313,23,13,422,284,67.3,138,32.7
2314,23,14,313,221,70.61,92,29.39
2315,23,15,350,241,68.86,109,31.14
2316,23,16,179,129,72.07,50,27.93
2317,23,17,241,182,75.52,59,24.48
2318,23,18,217,153,70.51,64,29.49
2319,23,19,185,134,72.43,51,27.57
2320,23,20,174,126,72.41,48,27.59
2321,23,21,154,114,74.03,40,25.97
2322,23,22,166,121,72.89,45,27.11
2323,23,23,169,126,74.56,43,25.44
2324,23,24,157,110,70.06,47,29.94
2325,23,25,136,110,80.88,26,19.12
2326,23,26,119,84,70.59,35,29.41
2327,23,27,140,106,75.71,34,24.29
2328,23,28,206,152,73.79,54,26.21
2329,23,29,289,208,71.97,81,28.03
2330,23,30,169,122,72.19,47,27.81
2331,23,31,195,147,75.38,48,24.62
2332,23,32,173,133,76.88,40,23.12
2333,23,33,383,283,73.89,100,26.11
2401,24,1,147,117,79.59,30,20.41
2402,24,2,154,124,80.52,30,19.48
2403,24,3,342,264,77.19,78,22.81
2404,24,4,276,213,77.17,63,22.83
2405,24,5,457,355,77.68,102,22.32
2406,24,6,309,234,75.73,75,24.27
2407,24,7,150,118,78.67,32,21.33
2408,24,8,199,150,75.38,49,24.62
2409,24,9,362,279,77.07,83,22.93
2410,24,10,281,219,77.94,62,22.06
2411,24,11,326,269,82.52,57,17.48
2412,24,12,376,298,79.26,78,20.74
2413,24,13,342,262,76.61,80,23.39
2414,24,14,258,192,74.42,66,25.58
2415,24,15,325,252,77.54,73,22.46
2416,24,16,427,290,67.92,137,32.08
2417,24,17,247,195,78.95,52,21.05
2418,24,18,411,256,62.29,155,37.71
2419,24,19,956,534,55.86,422,44.14
2501,25,1,289,194,67.13,95,32.87
2502,25,2,208,132,63.46,76,36.54
2503,25,3,289,174,60.21,115,39.79
2504,25,4,348,209,60.06,139,39.94
2505,25,5,418,271,64.83,147,35.17
2506,25,6,461,258,55.97,203,44.03
2507,25,7,447,255,57.05,192,42.95
2508,25,8,424,269,63.44,155,36.56
2509,25,9,460,268,58.26,192,41.74
2510,25,10,508,308,60.63,200,39.37
2511,25,11,452,288,63.72,164,36.28
2512,25,12,402,248,61.69,154,38.31
2513,25,13,593,403,67.96,190,32.04
2514,25,14,577,351,60.83,226,39.17
2515,25,15,457,349,76.37,108,23.63
2516,25,16,581,333,57.31,248,42.69
2517,25,17,249,173,69.48,76,30.52
2601,26,1,175,117,66.86,58,33.14
2602,26,2,243,147,60.49,96,39.51
2603,26,3,432,262,60.65,170,39.35
2604,26,4,241,174,72.2,67,27.8
2605,26,5,328,190,57.93,138,42.07
2606,26,6,206,121,58.74,85,41.26
2607,26,7,311,175,56.27,136,43.73
2608,26,8,227,141,62.11,86,37.89
2609,26,9,217,137,63.13,80,36.87
2610,26,10,253,147,58.1,106,41.9
2611,26,11,236,138,58.47,98,41.53
2612,26,12,98,60,61.22,38,38.78
2613,26,13,197,119,60.41,78,39.59
2614,26,14,142,96,67.61,46,32.39
2615,26,15,168,95,56.55,73,43.45
2616,26,16,394,214,54.31,180,45.69
2617,26,17,346,177,51.16,169,48.84
2618,26,18,168,111,66.07,57,33.93
2619,26,19,398,229,57.54,169,42.46
2620,26,20,429,241,56.18,188,43.82
2621,26,21,184,125,67.93,59,32.07
2622,26,22,157,98,62.42,59,37.58
2623,26,23,340,200,58.82,140,41.18
2624,26,24,164,108,65.85,56,34.15
2625,26,25,366,220,60.11,146,39.89
2626,26,26,395,216,54.68,179,45.32
2627,26,27,452,252,55.75,200,44.25
2628,26,28,396,231,58.33,165,41.67
2629,26,29,390,238,61.03,152,38.97
2630,26,30,227,125,55.07,102,44.93
2631,26,31,232,160,68.97,72,31.03
2632,26,32,328,218,66.46,110,33.54
2701,27,1,446,316,70.85,130,29.15
2702,27,2,585,449,76.75,136,23.25
2703,27,3,259,191,73.75,68,26.25
2704,27,4,403,306,75.93,97,24.07
2705,27,5,255,174,68.24,81,31.76
2706,27,6,502,373,74.3,129,25.7
2707,27,7,672,477,70.98,195,29.02
2708,27,8,160,122,76.25,38,23.75
2709,27,9,469,373,79.53,96,20.47
2710,27,10,267,203,76.03,64,23.97
2711,27,11,488,362,74.18,126,25.82
2712,27,12,360,262,72.78,98,27.22
2713,27,13,406,284,69.95,122,30.05
2714,27,14,308,228,74.03,80,25.97
2715,27,15,401,306,76.31,95,23.69
2716,27,16,563,417,74.07,146,25.93
2717,27,17,211,149,70.62,62,29.38
2718,27,18,492,376,76.42,116,23.58
2719,27,19,148,109,73.65,39,26.35
2720,27,20,269,211,78.44,58,21.56
2721,27,21,200,164,82.0,36,18.0
2722,27,22,285,215,75.44,70,24.56
2723,27,23,259,195,75.29,64,24.71
2724,27,24,150,122,81.33,28,18.67
2725,27,25,384,270,70.31,114,29.69
2726,27,26,424,307,72.41,117,27.59
2727,27,27,303,222,73.27,81,26.73
2728,27,28,339,256,75.52,83,24.48
2729,27,29,690,495,71.74,195,28.26
2801,28,1,220,166,75.45,54,24.55
2802,28,2,225,187,83.11,38,16.89
2803,28,3,74,55,74.32,19,25.68
2804,28,4,195,154,78.97,41,21.03
2805,28,5,172,138,80.23,34,19.77
2806,28,6,335,244,72.84,91,27.16
2807,28,7,149,100,67.11,49,32.89
2808,28,8,287,215,74.91,72,25.09
2809,28,9,154,119,77.27,35,22.73
2810,28,10,109,82,75.23,27,24.77
2811,28,11,452,304,67.26,148,32.74
2812,28,12,589,406,68.93,183,31.07
2813,28,13,463,372,80.35,91,19.65
2814,28,14,358,273,76.26,85,23.74
2815,28,15,207,152,73.43,55,26.57
2816,28,16,449,306,68.15,143,31.85
2817,28,17,249,192,77.11,57,22.89
2818,28,18,294,234,79.59,60,20.41
2819,28,19,291,251,86.25,40,13.75
2820,28,20,238,171,71.85,67,28.15
2821,28,21,245,197,80.41,48,19.59
2822,28,22,211,163,77.25,48,22.75
2823,28,23,285,233,81.75,52,18.25
2824,28,24,230,193,83.91,37,16.09
2825,28,25,402,323,80.35,79,19.65
2826,28,26,146,112,76.71,34,23.29
2901,29,1,469,314,66.95,155,33.05
2902,29,2,387,252,65.12,135,34.88
2903,29,3,326,236,72.39,90,27.61
2904,29,4,357,240,67.23,117,32.77
2905,29,5,370,267,72.16,103,27.84
2906,29,6,294,214,72.79,80,27.21
2907,29,7,582,419,71.99,163,28.01
2908,29,8,733,578,78.85,155,21.15
2909,29,9,322,261,81.06,61,18.94
2910,29,10,460,379,82.39,81,17.61
2911,29,11,394,302,76.65,92,23.35
2912,29,12,483,383,79.3,100,20.7
2913,29,13,486,389,80.04,97,19.96
2914,29,14,395,306,77.47,89,22.53
2915,29,15,393,295,75.06,98,24.94
2916,29,16,446,358,80.27,88,19.73
2917,29,17,282,226,80.14,56,19.86
2918,29,18,412,322,78.16,90,21.84
2919,29,19,479,366,76.41,113,23.59
2920,29,20,272,210,77.21,62,22.79
2921,29,21,321,231,71.96,90,28.04
2922,29,22,438,342,78.08,96,21.92
2923,29,23,427,344,80.56,83,19.44
2924,29,24,344,275,79.94,69,20.06
3001,30,1,446,295,66.14,151,33.86
3002,30,2,312,211,67.63,101,32.37
3003,30,3,420,282,67.14,138,32.86
3004,30,4,325,220,67.69,105,32.31
3005,30,5,351,239,68.09,112,31.91
3006,30,6,413,298,72.15,115,27.85
3007,30,7,278,201,72.3,77,27.7
3008,30,8,499,305,61.12,194,38.88
3009,30,9,420,293,69.76,127,30.24
3010,30,10,336,219,65.18,117,34.82
3011,30,11,299,216,72.24,83,27.76
3012,30,12,399,270,67.67,129,32.33
3013,30,13,320,214,66.88,106,33.13
3014,30,14,368,242,65.76,126,34.24
3015,30,15,530,358,67.55,172,32.45
3016,30,16,282,194,68.79,88,31.21
3017,30,17,385,269,69.87,116,30.13
3018,30,18,341,224,65.69,117,34.31
3019,30,19,213,141,66.2,72,33.8
3020,30,20,283,175,61.84,108,38.16
3021,30,21,465,315,67.74,150,32.26
3022,30,22,452,305,67.48,147,32.52
3023,30,23,490,346,70.61,144,29.39
3024,30,24,400,266,66.5,134,33.5
3025,30,25,263,176,66.92,87,33.08
3026,30,26,512,300,58.59,212,41.41
3101,31,1,277,189,68.23,88,31.77
3102,31,2,457,253,55.36,204,44.64
3103,31,3,246,166,67.48,80,32.52
3104,31,4,315,190,60.32,125,39.68
3105,31,5,288,194,67.36,94,32.64
3106,31,6,227,144,63.44,83,36.56
3107,31,7,271,191,70.48,80,29.52
3108,31,8,381,253,66.4,128,33.6
3109,31,9,244,155,63.52,89,36.48
3110,31,10,389,263,67.61,126,32.39
3111,31,11,366,259,70.77,107,29.23
3112,31,12,431,294,68.21,137,31.79
3113,31,13,325,233,71.69,92,28.31
3114,31,14,311,217,69.77,94,30.23
3115,31,15,139,101,72.66,38,27.34
3116,31,16,203,128,63.05,75,36.95
3117,31,17,264,168,63.64,96,36.36
3118,31,18,211,143,67.77,68,32.23
3119,31,19,278,208,74.82,70,25.18
3120,31,20,275,197,71.64,78,28.36
3121,31,21,275,192,69.82,83,30.18
3122,31,22,115,82,71.3,33,28.7
3123,31,23,157,99,63.06,58,36.94
3201,32,1,985,717,72.79,268,27.21
3202,32,2,775,561,72.39,214,27.61
3203,32,3,532,389,73.12,143,26.88
3204,32,4,550,423,76.91,127,23.09
3205,32,5,424,313,73.82,111,26.18
3206,32,6,257,188,73.15,69,26.85
3207,32,7,559,413,73.88,146,26.12
3208,32,8,395,293,74.18,102,25.82
3209,32,9,380,285,75.0,95,25.0
3210,32,10,711,521,73.28,190,26.72
3211,32,11,452,335,74.12,117,25.88
3212,32,12,273,201,73.63,72,26.37
3213,32,13,184,138,75.0,46,25.0
3214,32,14,808,601,74.38,207,25.62
3215,32,15,787,608,77.26,179,22.74
3216,32,16,390,313,80.26,77,19.74
3217,32,17,728,541,74.31,187,25.69
3218,32,18,295,201,68.14,94,31.86
3219,32,19,357,248,69.47,109,30.53
3220,32,20,735,550,74.83,185,25.17
3221,32,21,748,501,66.98,247,33.02
3222,32,22,734,495,67.44,239,32.56
3223,32,23,498,345,69.28,153,30.72
3224,32,24,259,182,70.27,77,29.73
3225,32,25,542,405,74.72,137,25.28
3226,32,26,718,524,72.98,194,27.02
3227,32,27,708,535,75.56,173,24.44
3228,32,28,205,147,71.71,58,28.29
3229,32,29,553,408,73.78,145,26.22
3230,32,30,707,506,71.57,201,28.43
3301,33,1,774,528,68.22,246,31.78
3302,33,2,840,565,67.26,275,32.74
3303,33,3,583,409,70.15,174,29.85
3304,33,4,797,520,65.24,277,34.76
3305,33,5,646,441,68.27,205,31.73
3306,33,6,703,447,63.58,256,36.42
3307,33,7,658,457,69.45,201,30.55
3308,33,8,468,318,67.95,150,32.05
3309,33,9,474,310,65.4,164,34.6
3310,33,10,499,328,65.73,171,34.27
3311,33,11,404,276,68.32,128,31.68
3312,33,12,614,397,64.66,217,35.34
3313,33,13,528,335,63.45,193,36.55
3314,33,14,717,460,64.16,257,35.84
3315,33,15,519,300,57.8,219,42.2
3316,33,16,679,488,71.87,191,28.13
3317,33,17,635,402,63.31,233,36.69
3401,34,1,500,368,73.6,132,26.4
3402,34,2,317,227,71.61,90,28.39
3403,34,3,679,517,76.14,162,23.86
3404,34,4,387,306,79.07,81,20.93
3405,34,5,669,505,75.49,164,24.51
3406,34,6,461,361,78.31,100,21.69
3407,34,7,219,174,79.45,45,20.55
3408,34,8,370,272,73.51,98,26.49
3409,34,9,692,509,73.55,183,26.45
3410,34,10,280,219,78.21,61,21.79
3411,34,11,470,360,76.6,110,23.4
3412,34,12,476,368,77.31,108,22.69
3413,34,13,585,455,77.78,130,22.22
3414,34,14,561,422,75.22,139,24.78
3415,34,15,450,343,76.22,107,23.78
3416,34,16,720,541,75.14,179,24.86
3417,34,17,640,455,71.09,185,28.91
3418,34,18,592,450,76.01,142,23.99
3419,34,19,469,380,81.02,89,18.98
3420,34,20,596,472,79.19,124,20.81
3501,35,1,175,114,65.14,61,34.86
3502,35,2,423,289,68.32,134,31.68
3503,35,3,323,196,60.68,127,39.32
3504,35,4,485,310,63.92,175,36.08
3505,35,5,667,369,55.32,298,44.68
3506,35,6,965,537,55.65,428,44.35
3507,35,7,663,378,57.01,285,42.99
3508,35,8,454,275,60.57,179,39.43
3509,35,9,774,421,54.39,353,45.61
3510,35,10,484,269,55.58,215,44.42
3511,35,11,653,403,61.72,250,38.28
3512,35,12,816,451,55.27,365,44.73
3513,35,13,550,294,53.45,256,46.55
3514,35,14,494,286,57.89,208,42.11
3515,35,15,637,369,57.93,268,42.07
3516,35,16,840,488,58.1,352,41.9
3517,35,17,535,355,66.36,180,33.64
3518,35,18,353,219,62.04,134,37.96
3519,35,19,534,333,62.36,201,37.64
3520,35,20,306,202,66.01,104,33.99
3521,35,21,482,309,64.11,173,35.89
3522,35,22,637,467,73.31,170,26.69
3601,36,1,260,164,63.08,96,36.92
3602,36,2,324,223,68.83,101,31.17
3603,36,3,262,165,62.98,97,37.02
3604,36,4,318,231,72.64,87,27.36
3605,36,5,253,173,68.38,80,31.62
3606,36,6,205,143,69.76,62,30.24
3607,36,7,179,123,68.72,56,31.28
3608,36,8,139,94,67.63,45,32.37
3609,36,9,385,277,71.95,108,28.05
3610,36,10,285,201,70.53,84,29.47
3611,36,11,204,142,69.61,62,30.39
3612,36,12,146,86,58.9,60,41.1
3613,36,13,79,46,58.23,33,41.77
3614,36,14,265,169,63.77,96,36.23
3615,36,15,130,84,64.62,46,35.38
3616,36,16,100,74,74.0,26,26.0
3617,36,17,386,216,55.96,170,44.04
3618,36,18,432,246,56.94,186,43.06
3619,36,19,556,336,60.43,220,39.57
3620,36,20,630,348,55.24,282,44.76
3621,36,21,424,275,64.86,149,35.14
3622,36,22,542,317,58.49,225,41.51
3623,36,23,482,313,64.94,169,35.06
3624,36,24,507,343,67.65,164,32.35
3625,36,25,578,385,66.61,193,33.39
3626,36,26,519,338,65.13,181,34.87
3627,36,27,577,394,68.28,183,31.72
3701,37,1,367,282,76.84,85,23.16
3702,37,2,295,216,73.22,79,26.78
3703,37,3,330,262,79.39,68,20.61
3704,37,4,357,273,76.47,84,23.53
3705,37,5,251,187,74.5,64,25.5
3706,37,6,468,362,77.35,106,22.65
3707,37,7,304,228,75.0,76,25.0
3708,37,8,434,333,76.73,101,23.27
3709,37,9,173,135,78.03,38,21.97
3710,37,10,301,242,80.4,59,19.6
3711,37,11,309,230,74.43,79,25.57
3712,37,12,413,312,75.54,101,24.46
3713,37,13,256,182,71.09,74,28.91
3714,37,14,398,326,81.91,72,18.09
3715,37,15,335,268,80.0,67,20.0
3716,37,16,426,327,76.76,99,23.24
3717,37,17,252,196,77.78,56,22.22
3718,37,18,316,240,75.95,76,24.05
3719,37,19,267,202,75.66,65,24.34
3720,37,20,433,350,80.83,83,19.17
3721,37,21,234,186,79.49,48,20.51
3722,37,22,310,231,74.52,79,25.48
3801,38,1,630,356,56.51,274,43.49
3802,38,2,329,195,59.27,134,40.73
3803,38,3,465,262,56.34,203,43.66
3804,38,4,335,205,61.19,130,38.81
3805,38,5,538,324,60.22,214,39.78
3806,38,6,360,214,59.44,146,40.56
3807,38,7,436,273,62.61,163,37.39
3808,38,8,367,214,58.31,153,41.69
3809,38,9,369,249,67.48,120,32.52
3810,38,10,357,228,63.87,129,36.13
3811,38,11,416,294,70.67,122,29.33
3812,38,12,575,356,61.91,219,38.09
3813,38,13,300,195,65.0,105,35.0
3814,38,14,388,255,65.72,133,34.28
3815,38,15,334,211,63.17,123,36.83
3816,38,16,567,345,60.85,222,39.15
3817,38,17,490,330,67.35,160,32.65
3818,38,18,588,402,68.37,186,31.63
3819,38,19,599,414,69.12,185,30.88
3820,38,20,498,337,67.67,161,32.33
3821,38,21,646,420,65.02,226,34.98
3822,38,22,440,301,68.41,139,31.59
3823,38,23,606,393,64.85,213,35.15
3824,38,24,569,387,68.01,182,31.99
3825,38,25,666,476,71.47,190,28.53
3901,39,1,462,328,71.0,134,29.0
3902,39,2,232,188,81.03,44,18.97
3903,39,3,392,286,72.96,106,27.04
3904,39,4,508,340,66.93,168,33.07
3905,39,5,359,252,70.19,107,29.81
3906,39,6,287,193,67.25,94,32.75
3907,39,7,260,190,73.08,70,26.92
3908,39,8,267,185,69.29,82,30.71
3909,39,9,240,172,71.67,68,28.33
3910,39,10,343,217,63.27,126,36.73
3911,39,11,213,146,68.54,67,31.46
3912,39,12,427,301,70.49,126,29.51
3913,39,13,652,463,71.01,189,28.99
3914,39,14,654,444,67.89,210,32.11
3915,39,15,536,384,71.64,152,28.36
3916,39,16,290,205,70.69,85,29.31
3917,39,17,718,466,64.9,252,35.1
3918,39,18,319,183,57.37,136,42.63
3919,39,19,656,480,73.17,176,26.83
3920,39,20,435,257,59.08,178,40.92
3921,39,21,564,379,67.2,185,32.8
3922,39,22,282,178,63.12,104,36.88
3923,39,23,60,39,65.0,21,35.0
3924,39,24,422,280,66.35,142,33.65
3925,39,25,300,211,70.33,89,29.67
3926,39,26,261,194,74.33,67,25.67
3927,39,27,257,177,68.87,80,31.13
3928,39,28,271,193,71.22,78,28.78
3929,39,29,130,97,74.62,33,25.38
3930,39,30,243,157,64.61,86,35.39
3931,39,31,309,212,68.61,97,31.39
3932,39,32,746,495,66.35,251,33.65
3933,39,33,267,182,68.16,85,31.84
3934,39,34,304,214,70.39,90,29.61
3935,39,35,540,381,70.56,159,29.44
4001,40,1,501,389,77.64,112,22.36
4002,40,2,531,418,78.72,113,21.28
4003,40,3,469,342,72.92,127,27.08
4004,40,4,492,357,72.56,135,27.44
4005,40,5,395,278,70.38,117,29.62
4006,40,6,453,340,75.06,113,24.94
4007,40,7,490,342,69.8,148,30.2
4008,40,8,323,237,73.37,86,26.63
4009,40,9,587,400,68.14,187,31.86
4010,40,10,885,643,72.66,242,27.34
4011,40,11,552,387,70.11,165,29.89
4012,40,12,608,439,72.2,169,27.8
4013,40,13,628,433,68.95,195,31.05
4014,40,14,817,483,59.12,334,40.88
4015,40,15,606,419,69.14,187,30.86
4016,40,16,605,400,66.12,205,33.88
4017,40,17,638,443,69.44,195,30.56
4018,40,18,695,465,66.91,230,33.09
4019,40,19,605,430,71.07,175,28.93
4020,40,20,695,488,70.22,207,29.78
4021,40,21,634,408,64.35,226,35.65
4022,40,22,877,557,63.51,320,36.49
4023,40,23,916,643,70.2,273,29.8
4101,41,1,363,220,60.61,143,39.39
4102,41,2,250,168,67.2,82,32.8
4103,41,3,270,168,62.22,102,37.78
4104,41,4,372,215,57.8,157,42.2
4105,41,5,410,234,57.07,176,42.93
4106,41,6,386,216,55.96,170,44.04
4107,41,7,336,186,55.36,150,44.64
4108,41,8,338,196,57.99,142,42.01
4109,41,9,650,394,60.62,256,39.38
4110,41,10,538,318,59.11,220,40.89
4111,41,11,405,260,64.2,145,35.8
4112,41,12,255,144,56.47,111,43.53
4113,41,13,572,355,62.06,217,37.94
4114,41,14,660,388,58.79,272,41.21
4115,41,15,837,479,57.23,358,42.77
4116,41,16,284,171,60.21,113,39.79
4117,41,17,195,113,57.95,82,42.05
4118,41,18,624,416,66.67,208,33.33
4119,41,19,309,196,63.43,113,36.57
4120,41,20,344,201,58.43,143,41.57
4121,41,21,340,202,59.41,138,40.59
4122,41,22,273,160,58.61,113,41.39
4123,41,23,396,222,56.06,174,43.94
4124,41,24,608,345,56.74,263,43.26
4125,41,25,534,286,53.56,248,46.44
4126,41,26,667,424,63.57,243,36.43
4127,41,27,472,282,59.75,190,40.25
4128,41,28,788,501,63.58,287,36.42
4129,41,29,814,542,66.58,272,33.42
4130,41,30,644,366,56.83,278,43.17
4131,41,31,569,319,56.06,250,43.94
4201,42,1,262,206,78.63,56,21.37
4202,42,2,242,182,75.21,60,24.79
4203,42,3,664,530,79.82,134,20.18
4204,42,4,564,436,77.3,128,22.7
4205,42,5,793,617,77.81,176,22.19
4206,42,6,341,273,80.06,68,19.94
4207,42,7,520,419,80.58,101,19.42
4208,42,8,354,276,77.97,78,22.03
4209,42,9,590,444,75.25,146,24.75
4210,42,10,392,279,71.17,113,28.83
4211,42,11,444,340,76.58,104,23.42
4212,42,12,341,247,72.43,94,27.57
4213,42,13,267,189,70.79,78,29.21
4214,42,14,201,156,77.61,45,22.39
4215,42,15,190,145,76.32,45,23.68
4216,42,16,645,479,74.26,166,25.74
4217,42,17,710,533,75.07,177,24.93
4218,42,18,395,301,76.2,94,23.8
4219,42,19,584,452,77.4,132,22.6
4220,42,20,588,445,75.68,143,24.32
4221,42,21,656,509,77.59,147,22.41
4222,42,22,649,466,71.8,183,28.2
4223,42,23,670,541,80.75,129,19.25
4224,42,24,660,521,78.94,139,21.06
4301,43,1,642,517,80.53,125,19.47
4302,43,2,764,607,79.45,157,20.55
4303,43,3,250,200,80.0,50,20.0
4304,43,4,506,405,80.04,101,19.96
4305,43,5,814,644,79.12,170,20.88
4306,43,6,941,738,78.43,203,21.57
4307,43,7,848,632,74.53,216,25.47
4308,43,8,705,527,74.75,178,25.25
4309,43,9,930,730,78.49,200,21.51
4310,43,10,599,461,76.96,138,23.04
4311,43,11,395,287,72.66,108,27.34
4312,43,12,758,592,78.1,166,21.9
4313,43,13,593,471,79.43,122,20.57
4314,43,14,352,270,76.7,82,23.3
4315,43,15,757,600,79.26,157,20.74
4316,43,16,310,239,77.1,71,22.9
4317,43,17,733,559,76.26,174,23.74
4318,43,18,863,670,77.64,193,22.36
4319,43,19,803,622,77.46,181,22.54
4320,43,20,670,531,79.25,139,20.75
4321,43,21,349,274,78.51,75,21.49
4322,43,22,827,665,80.41,162,19.59
4323,43,23,566,447,78.98,119,21.02
4401,44,1,828,619,74.76,209,25.24
4402,44,2,554,412,74.37,142,25.63
4403,44,3,719,593,82.48,126,17.52
4404,44,4,917,748,81.57,169,18.43
4405,44,5,723,531,73.44,192,26.56
4406,44,6,653,458,70.14,195,29.86
4407,44,7,686,492,71.72,194,28.28
4408,44,8,717,536,74.76,181,25.24
4409,44,9,958,707,73.8,251,26.2
4410,44,10,909,693,76.24,216,23.76
4411,44,11,737,516,70.01,221,29.99
4412,44,12,883,669,75.76,214,24.24
4413,44,13,868,615,70.85,253,29.15
4414,44,14,827,586,70.86,241,29.14
4415,44,15,915,690,75.41,225,24.59
4416,44,16,925,675,72.97,250,27.03
4417,44,17,940,705,75.0,235,25.0
4418,44,18,650,468,72.0,182,28.0
4419,44,19,873,600,68.73,273,31.27
4420,44,20,559,398,71.2,161,28.8
4421,44,21,916,660,72.05,256,27.95
4501,45,1,800,493,61.63,307,38.38
4502,45,2,429,302,70.4,127,29.6
4503,45,3,241,162,67.22,79,32.78
4504,45,4,297,191,64.31,106,35.69
4505,45,5,445,301,67.64,144,32.36
4506,45,6,520,339,65.19,181,34.81
4507,45,7,507,333,65.68,174,34.32
4508,45,8,429,267,62.24,162,37.76
4509,45,9,455,308,67.69,147,32.31
4510,45,10,478,295,61.72,183,38.28
4511,45,11,628,388,61.78,240,38.22
4512,45,12,403,263,65.26,140,34.74
4513,45,13,612,403,65.85,209,34.15
4514,45,14,353,224,63.46,129,36.54
4515,45,15,432,292,67.59,140,32.41
4516,45,16,517,374,72.34,143,27.66
4517,45,17,566,380,67.14,186,32.86
4518,45,18,557,393,70.56,164,29.44
4519,45,19,355,238,67.04,117,32.96
4520,45,20,479,334,69.73,145,30.27
4521,45,21,420,288,68.57,132,31.43
4522,45,22,535,372,69.53,163,30.47
4523,45,23,540,352,65.19,188,34.81
4524,45,24,453,290,64.02,163,35.98
4525,45,25,631,426,67.51,205,32.49
4526,45,26,469,328,69.94,141,30.06
4527,45,27,581,413,71.08,168,28.92
4528,45,28,514,339,65.95,175,34.05
4529,45,29,516,348,67.44,168,32.56
4601,46,1,646,495,76.63,151,23.37
4602,46,2,608,441,72.53,167,27.47
4603,46,3,727,497,68.36,230,31.64
4604,46,4,827,622,75.21,205,24.79
4605,46,5,672,520,77.38,152,22.62
4606,46,6,1020,729,71.47,291,28.53
4607,46,7,628,470,74.84,158,25.16
4608,46,8,795,561,70.57,234,29.43
4609,46,9,766,583,76.11,183,23.89
4610,46,10,711,463,65.12,248,34.88
4611,46,11,817,559,68.42,258,31.58
4612,46,12,987,753,76.29,234,23.71
4613,46,13,875,596,68.11,279,31.89
4614,46,14,484,331,68.39,153,31.61
4615,46,15,923,703,76.16,220,23.84
4616,46,16,680,476,70.0,204,30.0
4617,46,17,876,609,69.52,267,30.48
4618,46,18,819,561,68.5,258,31.5
4619,46,19,648,437,67.44,211,32.56
4620,46,20,586,434,74.06,152,25.94
4621,46,21,457,339,74.18,118,25.82
4622,46,22,562,417,74.2,145,25.8
4623,46,23,480,330,68.75,150,31.25
4701,47,1,658,452,68.69,206,31.31
4702,47,2,622,397,63.83,225,36.17
4703,47,3,620,415,66.94,205,33.06
4704,47,4,800,519,64.88,281,35.13
4705,47,5,904,521,57.63,383,42.37
4706,47,6,775,504,65.03,271,34.97
4707,47,7,1133,772,68.14,361,31.86
4708,47,8,702,451,64.25,251,35.75
4709,47,9,878,588,66.97,290,33.03
4710,47,10,768,492,64.06,276,35.94
4711,47,11,682,484,70.97,198,29.03
4712,47,12,502,363,72.31,139,27.69
4713,47,13,536,393,73.32,143,26.68
4714,47,14,674,495,73.44,179,26.56
4715,47,15,689,539,78.23,150,21.77
4716,47,16,712,530,74.44,182,25.56
4717,47,17,624,445,71.31,179,28.69
4718,47,18,787,518,65.82,269,34.18
4719,47,19,778,562,72.24,216,27.76
4720,47,20,758,536,70.71,222,29.29
4721,47,21,752,557,74.07,195,25.93
4722,47,22,611,443,72.5,168,27.5
4723,47,23,747,526,70.41,221,29.59
4724,47,24,868,605,69.7,263,30.3
4725,47,25,671,502,74.81,169,25.19
4726,47,26,852,639,75.0,213,25.0
4727,47,27,777,593,76.32,184,23.68
4728,47,28,549,414,75.41,135,24.59
4801,48,1,788,537,68.15,251,31.85
4802,48,2,248,197,79.44,51,20.56
4803,48,3,418,293,70.1,125,29.9
4804,48,4,448,312,69.64,136,30.36
4805,48,5,254,219,86.22,35,13.78
4806,48,6,625,446,71.36,179,28.64
4807,48,7,618,433,70.06,185,29.94
4808,48,8,395,306,77.47,89,22.53
4809,48,9,286,214,74.83,72,25.17
4810,48,10,745,493,66.17,252,33.83
4811,48,11,465,335,72.04,130,27.96
4812,48,12,659,457,69.35,202,30.65
4813,48,13,490,376,76.73,114,23.27
4814,48,14,580,432,74.48,148,25.52
4815,48,15,447,288,64.43,159,35.57
4816,48,16,354,260,73.45,94,26.55
4817,48,17,190,147,77.37,43,22.63
4818,48,18,621,410,66.02,211,33.98
4819,48,19,329,233,70.82,96,29.18
4820,48,20,233,186,79.83,47,20.17
4821,48,21,549,377,68.67,172,31.33
4822,48,22,314,259,82.48,55,17.52
4823,48,23,387,310,80.1,77,19.9
4824,48,24,745,513,68.86,232,31.14
4825,48,25,634,404,63.72,230,36.28
4826,48,26,330,264,80.0,66,20.0
4827,48,27,390,281,72.05,109,27.95
4828,48,28,543,348,64.09,195,35.91
4829,48,29,179,152,84.92,27,15.08
4830,48,30,565,407,72.04,158,27.96
4831,48,31,578,361,62.46,217,37.54
4832,48,32,452,323,71.46,129,28.54
4833,48,33,224,178,79.46,46,20.54
4834,48,34,439,292,66.51,147,33.49
4835,48,35,713,541,75.88,172,24.12
4901,49,1,670,482,71.94,188,28.06
4902,49,2,571,432,75.66,139,24.34
4903,49,3,787,578,73.44,209,26.56
4904,49,4,780,505,64.74,275,35.26
4905,49,5,828,594,71.74,234,28.26
4906,49,6,78,63,80.77,15,19.23
4907,49,7,809,588,72.68,221,27.32
4908,49,8,972,636,65.43,336,34.57
4909,49,9,875,544,62.17,331,37.83
4910,49,10,581,443,76.25,138,23.75
4911,49,11,632,474,75.0,158,25.0
4912,49,12,577,439,76.08,138,23.92
4913,49,13,721,543,75.31,178,24.69
4914,49,14,867,623,71.86,244,28.14
4915,49,15,790,555,70.25,235,29.75
4916,49,16,724,450,62.15,274,37.85
4917,49,17,835,564,67.54,271,32.46
5001,50,1,306,232,75.82,74,24.18
5002,50,2,356,252,70.79,104,29.21
5003,50,3,283,198,69.96,85,30.04
5004,50,4,350,251,71.71,99,28.29
5005,50,5,511,373,72.99,138,27.01
5006,50,6,244,185,75.82,59,24.18
5007,50,7,658,494,75.08,164,24.92
5008,50,8,443,343,77.43,100,22.57
5009,50,9,119,101,84.87,18,15.13
5010,50,10,257,181,70.43,76,29.57
5011,50,11,303,219,72.28,84,27.72
5012,50,12,121,89,73.55,32,26.45
5013,50,13,449,331,73.72,118,26.28
5014,50,14,87,60,68.97,27,31.03
5015,50,15,451,336,74.5,115,25.5
5016,50,16,85,56,65.88,29,34.12
5017,50,17,212,147,69.34,65,30.66
5018,50,18,34,19,55.88,15,44.12
5019,50,19,194,141,72.68,53,27.32
5020,50,20,182,144,79.12,38,20.88
5021,50,21,409,306,74.82,103,25.18
5022,50,22,358,256,71.51,102,28.49
5023,50,23,292,210,71.92,82,28.08
5024,50,24,365,250,68.49,115,31.51
5025,50,25,108,84,77.78,24,22.22
5026,50,26,180,130,72.22,50,27.78
5027,50,27,76,51,67.11,25,32.89
5028,50,28,458,348,75.98,110,24.02
